illicit	negative
scare	negative
reprehension	negative
striving	positive
tarnishes	negative
;	positive
outshine	positive
unpleasant	negative
commotions	negative
gaily	positive
;	negative
worked	positive
captivate	positive
wearisome	negative
toll	negative
enough	positive
obstruct	negative
loathsome	negative
degeneration	negative
cruelest	negative
filth	negative
Language	negative
cherish	positive
breakups	negative
discountenance	negative
ecenomical	positive
involuntarily	negative
ill-favored	negative
worrying	negative
self-criticism	negative
misstatement	negative
peaceful	positive
wripping	negative
admiration	positive
absurd	negative
hectic	negative
mysterious	negative
unreliability	negative
conference	positive
disastrously	negative
diabolic	negative
losers	negative
meaningless	negative
beutifully	positive
originality	positive
wince	negative
intimidating	negative
scourge	negative
enemy	negative
disses	negative
dejection	negative
flareup	negative
glimmer	positive
primitive	negative
refuting	negative
doom	negative
frequently	negative
incomprehensible	negative
redemption	positive
effrontery	negative
refute	negative
irregularity	negative
meritorious	positive
world-famous	positive
disallow	negative
perfidious	negative
brighter	positive
disliking	negative
erode	negative
civilize	positive
messes	negative
inexcusable	negative
idiotically	negative
unfunded	negative
not	positive
asunder	negative
entertaining	positive
skeptically	negative
backache	negative
fascist	negative
deteriorating	negative
purify	positive
complained	negative
lechery	negative
consistently	positive
majesty	positive
morality	positive
accost	negative
halcyon	positive
protracted	negative
butchery	negative
refreshed	positive
taxing	negative
lonesome	negative
imbecile	negative
fresh	positive
troublesome	negative
benifits	positive
abruptly	negative
dissonantly	negative
imposition	negative
abyss	negative
Minqing	positive
acclaim	positive
nebulously	negative
dispirit	negative
grapple	negative
unbearable	negative
subpoena	negative
flakey	negative
loot	negative
2-faced	negative
misguided	negative
upsets	negative
extraordinary	positive
;	negative
mournfully	negative
If	negative
of	negative
beggar	negative
imprudence	negative
courageousness	positive
sucked	negative
ghosting	negative
ineloquent	negative
you	positive
cruelly	negative
temptingly	positive
nervously	negative
hoard	negative
crush	negative
brave	positive
nastiness	negative
stew	negative
the	positive
discouragement	negative
gems	positive
jitter	negative
invasive	negative
ricer	negative
obsessive	negative
odder	negative
uncaring	negative
harrow	negative
cheerless	negative
the	positive
simpler	positive
restful	positive
blandish	negative
endorsement	positive
disillusions	negative
beg	negative
Minqing	negative
dishonor	negative
empower	positive
conciliatory	positive
fraudulent	negative
trustworthy	positive
destroy	negative
silly	negative
pandemonium	negative
irresponsible	negative
contaminated	negative
coupists	negative
downer	negative
rife	negative
inadverently	negative
deceiver	negative
painfull	negative
acclamation	positive
long-time	negative
ignore	negative
bowdlerize	negative
fortuitously	positive
leverage	positive
frighteningly	negative
gimmick	negative
slog	negative
gainfully	positive
hazard	negative
replaceable	positive
bland	negative
stresses	negative
eloquence	positive
susceptible	negative
ineffectual	negative
positive	negative
reticent	negative
praiseworthy	positive
disapointing	negative
deference	positive
snappish	negative
kid-friendly	positive
gutless	negative
miser	negative
anomaly	negative
heartless	negative
traitorously	negative
unreliable	negative
disfavor	negative
rectify	positive
pepping	positive
tattered	negative
unbelievably	negative
ugly	negative
International	negative
blame	negative
brilliantly	positive
two	negative
pout	negative
sinister	negative
finest	positive
proud	positive
laud	positive
vicious	negative
frenetic	negative
bumps	negative
cackle	negative
grotesque	negative
subsidizes	positive
jaded	negative
woeful	negative
protect	positive
catastrophe	negative
meaningful	positive
exhilaratingly	positive
spewed	negative
warmth	positive
viciously	negative
cravenly	negative
refuse	negative
lavish	positive
defame	negative
inordinate	negative
unwillingness	negative
fool	negative
trivialize	negative
damned	negative
tender	positive
quarrellous	negative
resolute	positive
ill-treated	negative
erodes	negative
gainsay	negative
dejected	negative
controversy	negative
disown	negative
gimmicked	negative
unlawfulness	negative
insane	negative
approval	positive
paradoxical	negative
cruelties	negative
dummy-proof	positive
uneasiness	negative
elimination	negative
alluringly	positive
maturity	positive
chaos	negative
defrauding	negative
intimidation	negative
"Sentiment	positive
adulatory	positive
appreciate	positive
prejudice	negative
accessable	positive
extremism	negative
screech	negative
divergent	negative
razor-sharp	positive
Bing	negative
corruption	negative
contradict	negative
radiant	positive
hard-working	positive
;	negative
nonexistent	negative
sharp	positive
oversize	negative
revengefully	negative
evade	negative
spitefulness	negative
irrationalities	negative
desert	negative
fractious	negative
regrettably	negative
dent	negative
trusted	positive
pleasant	positive
bravo	positive
meddlesome	negative
subjection	negative
plush	positive
raptureously	positive
noise	negative
invincible	positive
fuss	negative
truthfully	positive
word	positive
cheerful	positive
admire	positive
handily	positive
boredom	negative
subversively	negative
devoid	negative
irrecoverably	negative
industrious	positive
pleasantly	positive
nettlesome	negative
underpowered	negative
amusing	positive
impulsive	negative
zenith	positive
euphorically	positive
impolitic	negative
overdo	negative
pros	positive
confront	negative
torrent	negative
freaks	negative
rocky	negative
insignificant	negative
defeated	positive
apprehensions	negative
indistinguishable	negative
hubris	negative
cancerous	negative
worn	negative
frustrating	negative
adorer	positive
calm	positive
words).	negative
passionately	positive
savior	positive
lurk	negative
clamorous	negative
complements	positive
peevish	negative
blur	negative
expeditiously	positive
respectful	positive
caricature	negative
goof	negative
promises	positive
enflame	negative
seething	negative
supreme	positive
finagle	negative
infections	negative
restricted	negative
maniacal	negative
reproachful	negative
backwood	negative
courageous	positive
stalls	negative
agonizingly	negative
indiscernible	negative
gratitude	positive
overdone	negative
drawback	negative
discomfort	negative
apocalyptic	negative
subpoenas	negative
forlornly	negative
opponent	negative
disadvantaged	negative
agonizing	negative
drones	negative
prik	negative
depraved	negative
prospros	positive
notoriety	negative
flaws	negative
greed	negative
doubt	negative
tenuously	negative
dead-cheap	positive
scandalous	negative
state-of-the-art	positive
deterioration	negative
swindle	negative
self-destructive	negative
radical	negative
brutalizing	negative
suitable	positive
file	negative
ignoble	negative
anxiousness	negative
bigotry	negative
valiant	positive
lively	positive
subsidize	positive
daunt	negative
desperately	negative
well-run	positive
mockeries	negative
flagrant	negative
overweight	negative
snappy	positive
oversimplify	negative
heedless	negative
unintelligible	negative
outbursts	negative
hearten	positive
devilish	negative
won	positive
hacks	negative
decadence	negative
selfish	negative
caustically	negative
alarmingly	negative
indoctrinate	negative
surrender	negative
flairs	negative
fevers	negative
proprietary	negative
cashbacks	positive
;	positive
remorselessness	negative
ill-formed	negative
junk	negative
rust	negative
insociable	negative
killer	negative
unspecified	negative
chatterbox	negative
wail	negative
unfamiliar	negative
screw-up	negative
epidemic	negative
intolerable	negative
stern	negative
ill-advised	negative
impoverished	negative
words	positive
disobedience	negative
glorify	positive
shirk	negative
counter-attack	positive
spotless	positive
inaccurately	negative
stinks	negative
affront	negative
bleakness	negative
cringe	negative
ill-usage	negative
mischievous	negative
backbone	positive
If	positive
proactive	positive
;	positive
divisive	negative
fortunate	positive
opinion.	positive
sorely	negative
free	positive
gladness	positive
lewdness	negative
inconsequently	negative
cursed	negative
wastefulness	negative
unuseable	negative
satirize	negative
taunting	negative
the	negative
unspeakablely	negative
leery	negative
indiscreet	negative
layoff	negative
irrecoverable	negative
dismayingly	negative
cynicism	negative
corrosion	negative
prickles	negative
lapses	negative
respect	positive
perfunctory	negative
mesmerize	positive
hardhearted	negative
antipathy	negative
easy-to-use	positive
amenity	positive
blind	negative
asinininity	negative
bulkyness	negative
list	negative
dubitable	negative
sillily	negative
grumpiest	negative
revere	positive
commendable	positive
inequitably	negative
dismay	negative
not	negative
compassionate	positive
diffidence	negative
cuteness	positive
wrath	negative
raked	negative
seamless	positive
reprehensible	negative
problems	negative
insurrection	negative
aspersions	negative
condemns	negative
The	negative
screwy	negative
compatible	positive
disgusting	negative
revitalize	positive
virtuously	positive
staunchly	positive
Conference	negative
deservedly	positive
blinding	negative
smooth	positive
drop-out	negative
sagely	positive
versatility	positive
desiccated	negative
fried	negative
procrastination	negative
best-known	positive
rage	negative
charismatic	positive
musty	negative
vindictively	negative
staid	negative
ho-hum	negative
inconvenience	negative
foul	negative
eye-catch	positive
untruthful	negative
mistress	negative
radically	negative
hurtful	negative
slaughtered	negative
misbecoming	negative
an	positive
lonely	negative
devastate	negative
hard-line	negative
offender	negative
fusty	negative
ardor	positive
incomparably	negative
togetherness	positive
friction	negative
jumpy	negative
disaffected	negative
marveled	positive
scrambling	negative
propagandize	negative
endearing	positive
besiege	negative
damages	negative
supple	positive
moron	negative
unreal	positive
inflationary	negative
inability	negative
spellbinding	positive
irrationals	negative
patronize	negative
chatter	negative
evil	negative
peps	positive
spade	negative
in	positive
appear	negative
attractively	positive
deviousness	negative
on	positive
disparage	negative
pique	negative
maddeningly	negative
distrustful	negative
touchy	negative
slap	negative
disaffirm	negative
groundless	negative
spoiled	negative
pitiable	negative
water-down	negative
bemoan	negative
poignant	positive
worthwhile	positive
bullish	positive
rewardingly	positive
steals	negative
high-spirited	positive
failed	negative
beneficent	positive
scathingly	negative
uncertain	negative
bulkier	negative
subordinate	negative
refreshing	positive
dinky	negative
eulogize	positive
undue	negative
impossiblity	negative
all	positive
imaginative	positive
overjoyed	positive
victory	positive
ideally	positive
sink	negative
ignominiously	negative
depressingly	negative
rhapsodize	negative
nagging	negative
negation	negative
warned	negative
disillusion	negative
enthusiasm	positive
appall	negative
appropriate	positive
naive	negative
necessarily	negative
mistakes.	negative
illegitimate	negative
fiend	negative
freedoms	positive
resentful	negative
crisper	positive
wholeheartedly	positive
shrouded	negative
irritating	negative
whore	negative
file	negative
fortune	positive
propitious	positive
pluses	positive
happy	positive
prohibit	negative
overkill	negative
dictator	negative
backwoods	negative
disbeliever	negative
marvellous	positive
bungle	negative
complicit	negative
shaky	negative
culprit	negative
shortcomings	negative
mortification	negative
anomalous	negative
spacious	positive
disagrees	negative
debilitating	negative
inappropriate	negative
outrageously	negative
disrespectfulness	negative
unthinkably	negative
tiringly	negative
incomprehension	negative
undissolved	negative
despondence	negative
gains	positive
fawningly	negative
embarrassingly	negative
shunned	negative
smell	negative
mysteriously	negative
indolent	negative
thinner	positive
lean	positive
uphold	positive
realistic	positive
honest	positive
effusively	positive
ambivalent	negative
crushing	negative
hatred	negative
aggressive	negative
crippled	negative
refutation	negative
humid	negative
the	negative
insubstantial	negative
uncompetitive	negative
picketed	negative
bashful	negative
controversial	negative
complain	negative
terrorize	negative
well-bred	positive
bumpy	negative
inculcate	negative
indiscriminately	negative
words	positive
flees	negative
intefere	negative
mastery	positive
fastest	positive
steeply	negative
insensitively	negative
patiently	positive
limit	negative
dump	negative
wrought	negative
condemnation	negative
2004,	negative
detestably	negative
irreplacible	negative
loveliness	positive
parody	negative
excitedly	positive
reluctance	negative
lividly	negative
exhilaration	positive
enjoin	negative
;	positive
wariness	negative
puzzled	negative
burned	negative
aspersion	negative
conspiracies	negative
lawless	negative
pamperedness	positive
improperly	negative
wins	positive
opinion	positive
profound	positive
masterfully	positive
sincerely	positive
benefits	positive
defensive	negative
mists	negative
disruption	negative
pride	positive
succeed	positive
evenly	positive
debilitate	negative
rumbling	negative
whine	negative
pricier	negative
explode	negative
spank	negative
lovely	positive
alienate	negative
They	positive
precarious	negative
swamped	negative
unilateralism	negative
debauch	negative
invader	negative
collapse	negative
frustrations	negative
detriment	negative
tease	negative
impeach	negative
flawless	positive
Reviews."	negative
altruistically	positive
aversion	negative
unusually	negative
resound	positive
N.	negative
stunningly	positive
pep	positive
craven	negative
frequently	positive
coercion	negative
infringement	negative
entrancing	positive
Seattle,	negative
torture	negative
finicky	negative
combust	negative
overstated	negative
undermines	negative
quarrels	negative
likes	positive
luxury	positive
arrogant	negative
audaciously	negative
abrasive	negative
touts	negative
promoter	positive
flagging	negative
saint	positive
heal	positive
trashy	negative
indiscriminating	negative
moribund	negative
broken	negative
bitchy	negative
avidly	positive
unattractive	negative
profusion	positive
contaminating	negative
sturdier	positive
obscurity	negative
frazzled	negative
retarded	negative
sparkling	positive
righteousness	positive
extremists	negative
ailing	negative
antagonist	negative
invalid	negative
bereft	negative
enhanced	positive
polite	positive
concede	negative
effectual	positive
Data	positive
supports	positive
disorganized	negative
euphoric	positive
illusory	negative
overwhelmed	negative
blurt	negative
deviously	negative
plague	negative
palatial	positive
invisible	negative
sucker	negative
back-logged	negative
hypocricy	negative
disillusionment	negative
exceeds	positive
headache	negative
inconveniently	negative
predicament	negative
;	positive
misspelled	negative
welcome	positive
Processing,	negative
undermine	negative
transgress	negative
harmless	positive
debatable	negative
pleasurable	positive
flutter	positive
inglorious	negative
disreputable	negative
erase	negative
tingling	negative
enjoys	positive
support	positive
unprepared	negative
dumps	negative
disagreed	negative
affirmation	positive
nourish	positive
tyrannical	negative
mocked	negative
chide	negative
unlucky	negative
stale	negative
regressive	negative
acridness	negative
aggression	negative
scarily	negative
super	positive
urgent	negative
growl	negative
sufficed	positive
stalemate	negative
confuse	negative
obnoxiously	negative
bolster	positive
cripples	negative
smiling	positive
disregard	negative
negative	negative
laggy	negative
molest	negative
manic	negative
torturing	negative
erroneously	negative
disgustfully	negative
decayed	negative
frictions	negative
capitulate	negative
charming	positive
following	positive
deprave	negative
sweeten	positive
exceedingly	positive
uncompromisingly	negative
sadness	negative
shock	negative
dishearten	negative
extoll	positive
dumbfounding	positive
repression	negative
flareups	negative
paradoxically	negative
sourly	negative
included	positive
smother	negative
flimflam	negative
reformed	positive
14th	negative
savages	negative
vestiges	negative
brash	negative
detract	negative
counterproductive	negative
immodest	negative
exaggeration	negative
They	positive
amiabily	positive
first-in-class	positive
improvement	positive
dehumanization	negative
gusto	positive
giddy	negative
slanderer	negative
cheats	negative
well-informed	positive
waning	negative
stain	negative
discriminate	negative
miracles	positive
unimportant	negative
desperation	negative
adversity	negative
invective	negative
delightful	positive
glum	negative
intrigue	positive
wrong	negative
indecent	negative
promised	positive
dissemble	negative
zeal	positive
stigmatize	negative
hefty	negative
vomited	negative
excitedness	positive
pointless	negative
salute	positive
infamous	negative
insultingly	negative
revel	positive
byzantine	negative
monumental	positive
wound	negative
;	positive
beastly	negative
blasphemous	negative
idolized	positive
soft	positive
invulnerable	positive
ignorance	negative
insufficiency	negative
file	positive
disconcertingly	negative
doubtless	positive
dissappointing	negative
rational	positive
loner	negative
delectable	positive
amusingly	positive
darken	negative
prosperous	positive
doubtful	negative
sensational	positive
ax	negative
chafe	negative
stirringly	positive
low-price	positive
strict	negative
smelling	negative
quibble	negative
blurring	negative
incite	negative
realizable	positive
snags	negative
keen	positive
loophole	negative
inexorably	negative
corrosive	negative
ill-mannered	negative
adulteration	negative
fragile	negative
died	negative
appal	negative
unknown	negative
unsure	negative
compliant	positive
redeeming	positive
appreciatively	positive
calumniate	negative
Opinion	negative
inevitable	negative
forsaken	negative
glitch	negative
triumph	positive
regard	positive
renewed	positive
"Opinion	positive
word	negative
recourses	negative
capriciousness	negative
famed	positive
dictatorial	negative
the	positive
futurestic	positive
thoughtful	positive
heroine	positive
fast-growing	positive
antagonistic	negative
receptive	positive
sentiment	positive
attacks	negative
heartbreaking	negative
ardently	positive
lemon	negative
lead	positive
biting	negative
2005,	negative
enjoyment	positive
Observer:	positive
stark	negative
stooge	negative
snazzy	positive
scrap	negative
syndrome	negative
imprecision	negative
meltdown	negative
inexpiable	negative
heinous	negative
ultra-hardline	negative
vengefully	negative
unresolved	negative
easing	positive
mudslinger	negative
loyalty	positive
proficiently	positive
words	negative
phenomenal	positive
hack	negative
contains	negative
contravene	negative
punctual	positive
rapturously	positive
chagrin	negative
good	positive
ignominy	negative
soulful	positive
bigotries	negative
lier	negative
troublemaker	negative
fidget	negative
resourcefulness	positive
violate	negative
brainiest	positive
lambast	negative
prodigiously	positive
disappointments	negative
progressive	positive
tin-y	negative
traumatically	negative
morons	negative
battered	negative
nicest	positive
stigma	negative
abort	negative
persecute	negative
favorite	positive
triumphant	positive
sputter	negative
file	positive
peaceable	positive
magnificence	positive
tauntingly	negative
feasibly	positive
hard-liner	negative
pleased	positive
daring	positive
devastating	negative
irreformable	negative
lawlessness	negative
downbeat	negative
blithe	positive
stump	negative
sociable	positive
adroit	positive
solidarity	positive
disagreement	negative
appalling	negative
well-being	positive
oddities	negative
stupid	negative
skill	positive
feature-rich	positive
falls	negative
stressfully	negative
unforeseen	negative
excellently	positive
misleading	negative
bane	negative
divine	positive
trash	negative
gratified	positive
impudent	negative
blow	negative
averse	negative
;	positive
bleed	negative
fatuity	negative
affordable	positive
humor	positive
painfully	negative
lunaticism	negative
obsess	negative
foolish	negative
enfeeble	negative
delicate	positive
variety	positive
break	negative
disconsolate	negative
sabotage	negative
enrichment	positive
irritate	negative
titillating	positive
stormy	negative
softer	positive
critical	negative
hallucination	negative
leading	positive
exagerate	negative
battering	negative
jolly	positive
rock-stars	positive
solicitous	positive
inteferes	negative
annoyance	negative
complemented	positive
awesomeness	positive
joyful	positive
floored	negative
obliterate	negative
overreach	negative
disrespectfully	negative
abomination	negative
dubious	negative
hype	negative
incredulously	negative
inconsequentially	negative
impermissible	negative
simplified	positive
extraneous	negative
traitor	negative
imprecisely	negative
dents	negative
reactionary	negative
misgivings	negative
absurdly	negative
lovably	positive
well-rounded	positive
discredit	negative
excruciating	negative
exuberant	positive
notice	positive
dishonestly	negative
breakup	negative
overstatement	negative
awestruck	positive
impertinent	negative
overlook	negative
NEGATIVE	negative
dings	negative
self-interest	negative
denying	negative
wonder	positive
bull----	negative
gem	positive
discomfititure	negative
stupified	negative
indifferent	negative
raging	negative
degradingly	negative
convincingly	positive
discordant	negative
unaffordable	negative
empathy	positive
unequivocally	positive
killjoy	negative
harridan	negative
Cheng.	negative
carelessness	negative
smuttiest	negative
disorderly	negative
seedy	negative
toll-free	positive
irrecoverableness	negative
chic	positive
condemned	negative
truthfulness	positive
imperfect	negative
swipe	negative
racy	negative
calamity	negative
haggle	negative
achievable	positive
darkness	negative
supremacy	positive
patriot	positive
blundering	negative
condemnable	negative
cooperative	positive
playfully	positive
fertile	positive
tawdry	negative
clear-cut	positive
bloodthirsty	negative
irresolute	negative
easiness	positive
hardliner	negative
danke	positive
kudos	positive
inaccurate	negative
dumbfounded	positive
grateful	positive
renown	positive
flirt	negative
inundate	negative
cost-saving	positive
merciless	negative
fanaticism	negative
inapt	negative
shit	negative
freezing	negative
falsify	negative
adamant	negative
indecisive	negative
superficiality	negative
evildoer	negative
brisk	positive
self-defeating	negative
Hu	negative
punishable	negative
reprehensibly	negative
blockage	negative
imperfection	negative
well-intentioned	positive
spotty	negative
reconcile	positive
bewilder	negative
quitter	negative
vomiting	negative
You	negative
vagueness	negative
detracts	negative
damnable	negative
impress	positive
fissures	negative
peach	positive
issue-free	positive
firmer	positive
spoon-feed	negative
subversive	negative
efficiently	positive
unlawful	negative
grieving	negative
bored	negative
savings	positive
reachable	positive
grudging	negative
blockbuster	positive
argumentative	negative
enviousness	positive
embarrass	negative
far-fetched	negative
papers:	negative
statuesque	positive
breeze	positive
dismayed	negative
mangles	negative
stagnant	negative
loathe	negative
fuck	negative
incense	negative
treachery	negative
two-faced	negative
hot	positive
eager	positive
unruly	negative
exhausted	negative
jittery	negative
invidiousness	negative
nonsense	negative
adequate	positive
gravely	negative
brighten	positive
lull	negative
flake	negative
negligence	negative
sweaty	negative
hardier	positive
popular	positive
lyrical	positive
fragrant	positive
sulk	negative
survival	positive
disingenuous	negative
spoilage	negative
lorn	negative
watered-down	negative
compulsion	negative
undermining	negative
exasperate	negative
or	negative
commodious	positive
misunderstandings	negative
talent	positive
use	negative
bother	negative
rejoicing	positive
gauche	negative
misunderstood	negative
excoriate	negative
celebrated	positive
ergonomical	positive
pertinaciously	negative
dependably	positive
dumb	negative
freed	positive
complex	negative
ruining	negative
work	positive
scant	negative
presumptuous	negative
self-respect	positive
rejuvenated	positive
portable	positive
dynamic	positive
comely	positive
confident	positive
fashionably	positive
paradise	positive
regally	positive
logical	positive
smudged	negative
congratulations	positive
and	positive
solid	positive
misguidance	negative
frightful	negative
defiant	negative
horrify	negative
negative	positive
luckiness	positive
tetchily	negative
sharpest	positive
sarcastically	negative
loneliness	negative
achievible	positive
nauseatingly	negative
unlamentably	negative
insubordinate	negative
fluent	positive
ambitious	positive
glamorous	positive
rigid	negative
lackey	negative
gross	negative
terrible	negative
helpful	positive
bullies	negative
ready	positive
licentiousness	negative
fiery	positive
impartiality	positive
tragically	negative
pig	negative
luckier	positive
dumped	negative
displace	negative
unsophisticated	negative
delighted	positive
pessimistically	negative
jeopardy	negative
restrictive	negative
corrosions	negative
usurp	negative
earsplitting	negative
celebration	positive
intelligence	positive
illogically	negative
these	negative
disrespectable	negative
Lexicon:	positive
safe	positive
smudges	negative
insecurity	negative
losing	negative
inexperience	negative
remorseful	negative
twist	negative
solemn	negative
stodgy	negative
strikingly	positive
imbroglio	negative
worth	positive
succeeds	positive
parasite	negative
fanatical	negative
coldly	negative
An	negative
stimulative	positive
traped	negative
disgusted	negative
instability	negative
respite	positive
inexpert	negative
famine	negative
lech	negative
jubilate	positive
jeeringly	negative
indiscriminate	negative
gallantly	positive
gained	positive
cheap	negative
snub	negative
capsize	negative
judder	negative
contrariness	negative
scornfully	negative
hurting	negative
madden	negative
viper	negative
expertly	positive
predatory	negative
mad	negative
cumbersome	negative
flourish	positive
thriving	positive
superfluous	negative
importune	negative
terribly	negative
fictitious	negative
hypocrites	negative
god-given	positive
brimstone	negative
scoundrel	negative
poky	negative
falsely	negative
distorted	negative
penalize	negative
atrocity	negative
uneventful	negative
flounder	negative
disordered	negative
wrongly	negative
inextricably	negative
hysterical	negative
luckiest	positive
steep	negative
manipulators	negative
improper	negative
mourn	negative
reassure	positive
kook	negative
instructive	positive
low-cost	positive
user-replaceable	positive
pimple	negative
beckons	positive
stains	negative
gutter	negative
perilously	negative
dismissive	negative
nonresponsive	negative
22-25,	positive
aweful	negative
disrupt	negative
daze	negative
devout	positive
and	positive
torturous	negative
misinformed	negative
beloved	positive
bedlam	negative
preferring	positive
sneak	negative
humming	negative
lackluster	negative
bash	negative
inappropriately	negative
unachievable	negative
adverse	negative
degradation	negative
trendy	positive
suffer	negative
despoil	negative
insanity	negative
recession	negative
queer	negative
compulsive	negative
squash	negative
swagger	negative
champion	positive
gratifies	positive
dreadfully	negative
earnestness	positive
inhuman	negative
rankle	negative
ironic	negative
generous	positive
hysteria	negative
aimless	negative
regress	negative
goading	negative
sneakily	negative
jealousness	negative
scar	negative
vibrant	positive
sardonic	negative
merciful	positive
lawful	positive
authoritarian	negative
insolent	negative
convient	positive
acclaimed	positive
oddly	negative
hardball	negative
persecution	negative
satisified	positive
indecorum	negative
tumultuous	negative
overrated	negative
empathize	positive
opinion	positive
oppress	negative
diappointed	negative
wary	negative
dilly-dally	negative
atrocities	negative
overwhelm	negative
valiantly	positive
slime	negative
steadfastly	positive
remedy	positive
asininely	negative
zap	negative
failures	negative
sagged	negative
commendably	positive
illogical	negative
slower	negative
imposers	negative
uproar	negative
failure	negative
sueing	negative
articulate	positive
unwanted	negative
risk	negative
achievement	positive
corrupts	negative
fainthearted	negative
vibration	negative
terrorism	negative
smartly	positive
vilify	negative
stole	negative
jealousy	negative
stellar	positive
poisonously	negative
scarier	negative
fraught	negative
dies	negative
that	negative
remorsefully	negative
disappointment	negative
bonuses	positive
propaganda	negative
fatuously	negative
demon	negative
apologist	negative
irredeemably	negative
complacent	negative
solicitously	positive
discriminatory	negative
benevolent	positive
self-coup	negative
ailment	negative
displease	negative
on	negative
wreaks	negative
fiasco	negative
calumnious	negative
abominate	negative
eccentric	negative
impolitely	negative
Analysis	positive
beautifullly	positive
dispiritedly	negative
retaliate	negative
overloaded	negative
sporty	positive
vivid	positive
motivated	positive
on	positive
freaking	negative
squander	negative
skilled	positive
eventful	positive
praising	positive
puppet	negative
infuriatingly	negative
oversights	negative
droop	negative
angel	positive
compact	positive
dragged	negative
perfect	positive
passionate	positive
deplete	negative
thrilling	positive
destruction	negative
sceptical	negative
boundless	positive
beleaguer	negative
ineptly	negative
devastatingly	negative
plentiful	positive
unwieldy	negative
loyal	positive
saintliness	positive
exorbitantly	negative
lag	negative
blister	negative
forbidden	negative
aggressiveness	negative
enthusiast	positive
rifts	negative
cheery	positive
dissolute	negative
imaculate	positive
absurdness	negative
swelling	negative
ecstatically	positive
autonomous	positive
dominate	positive
charm	positive
dissent	negative
smarter	positive
ostracize	negative
wrest	negative
damper	negative
amazing	positive
precisely	positive
mercy	positive
faults	negative
delight	positive
vibrantly	positive
acumen	positive
imaginary	negative
funny	negative
horrible	negative
disasterous	negative
skittishly	negative
mawkish	negative
innuendo	negative
insurmountable	negative
doddering	negative
top-quality	positive
subsidizing	positive
agile	positive
honored	positive
as	negative
magic	positive
chasten	negative
strange	negative
scowl	negative
amazes	positive
transparent	positive
delinquent	negative
leaking	negative
pathetic	negative
reverent	positive
laudable	positive
oppositions	negative
startlingly	negative
errors	negative
viewable	positive
are	negative
imperfectly	negative
strenuous	negative
enhancement	positive
cruelty	negative
wonderfully	positive
blab	negative
satirical	negative
malice	negative
caustic	negative
hateful	negative
condescending	negative
spiritual	positive
cheesy	negative
honor	positive
pamperedly	positive
dumbfound	negative
enlightenment	positive
bewildered	negative
underpaid	negative
subsidized	positive
sorry	negative
revelation	positive
contend	negative
cute	positive
Second	negative
greatness	positive
smolder	negative
enraging	negative
well-connected	positive
crooks	negative
bugging	negative
hum	negative
You	positive
restored	positive
This	negative
snagged	negative
disrespectablity	negative
Second	positive
harm	negative
grief	negative
malevolent	negative
dropout	negative
jollify	positive
manipulation	negative
well-behaved	positive
distressing	negative
leer	negative
irately	negative
stringently	negative
properly	positive
;	positive
disconsolation	negative
premeditated	negative
tamper	negative
paralize	negative
inconsistence	negative
suspicion	negative
peeled	negative
aggravating	negative
recommendation	positive
villian	negative
immoderate	negative
disgrace	negative
wowed	positive
perverts	negative
foreboding	negative
inventive	positive
substandard	negative
discrepant	negative
and	positive
moan	negative
misalign	negative
pretty	positive
significant	positive
;	negative
achey	negative
rightness	positive
taint	negative
exceed	positive
;	negative
fanciful	negative
irreversible	negative
exceptional	positive
torment	negative
cohere	positive
loves	positive
genial	positive
backbite	negative
pillage	negative
bores	negative
cartoonish	negative
backaching	negative
grievous	negative
ebulliently	positive
infallible	positive
inflict	negative
dedicated	positive
intimate	positive
dizzing	negative
murderer	negative
proving	positive
;	positive
sidetrack	negative
spewing	negative
luxurious	positive
congested	negative
onerous	negative
spoilled	negative
repulsing	negative
harpy	negative
charisma	positive
infamy	negative
peeved	negative
unsettle	negative
unexpectedly	negative
dirts	negative
pessimism	negative
abusive	negative
unnoticed	negative
admonishment	negative
convenience	positive
grouse	negative
stupify	negative
feint	negative
plagiarize	negative
unworkable	negative
virtuous	positive
inefficiency	negative
stunt	negative
hard-hit	negative
upset	negative
beggarly	negative
improbability	negative
vengefulness	negative
denunciations	negative
graciousness	positive
conspirator	negative
beautifully	positive
sentence	positive
classic	positive
dread	negative
woefully	negative
grossly	negative
foolishly	negative
ravage	negative
irrelevance	negative
despotic	negative
ugh	negative
stimulating	positive
anxiously	negative
deplore	negative
favour	positive
dexterously	positive
anxiety	negative
bruising	negative
occludes	negative
high-priced	negative
strangle	negative
Customer	negative
chore	negative
exhilarating	positive
droops	negative
unseemly	negative
undisputable	positive
daunting	negative
successfully	positive
flighty	negative
irretating	negative
cherub	positive
responsibly	positive
Junsheng	positive
doggedly	negative
compliment	positive
below:	positive
fume	negative
enthrall	positive
ineffectualness	negative
inexplainable	negative
from	positive
uncomfortably	negative
discombobulate	negative
mesmerized	positive
gabble	negative
simplifies	positive
rubbish	negative
stability	positive
maneuverable	positive
domineering	negative
discompose	negative
revulsive	negative
risky	negative
distraughtly	negative
blasphemy	negative
acerbically	negative
deplorably	negative
J.	negative
fashionable	positive
captivating	positive
flares	negative
unsustainable	negative
inveigle	negative
crazily	negative
twisted	negative
abrade	negative
arbitrary	negative
disquieting	negative
and	negative
miraculous	positive
legendary	positive
passiveness	negative
farcical	negative
sober	negative
following	negative
perturbed	negative
slowly	negative
the	negative
unwisely	negative
economical	positive
unhappily	negative
disliked	negative
glibly	negative
outcast	negative
unable	negative
distressingly	negative
accursed	negative
hotbeds	negative
apathy	negative
misspelled	negative
versatile	positive
ineffectively	negative
overturn	negative
contemptible	negative
irrational	negative
brilliance	positive
niggle	negative
youthful	positive
misbecome	negative
inexorable	negative
pittance	negative
cunts	negative
catastrophes	negative
stinging	negative
tyrant	negative
failing	negative
sedentary	negative
debts	negative
beautify	positive
clog	negative
unfit	negative
incompetently	negative
dastard	negative
hedonistic	negative
rejuvenate	positive
pampered	positive
Opinion	positive
tormented	negative
vain	negative
impractical	negative
paper	negative
pretence	negative
superficially	negative
interesting	positive
obstruction	negative
escapade	negative
criticize	negative
scratchy	negative
Hu	positive
bonkers	negative
felon	negative
judicious	positive
damaging	negative
ineloquently	negative
slack	negative
cleanliness	positive
and	positive
prate	negative
treason	negative
apathetically	negative
subtract	negative
hoodium	negative
heckled	negative
unjustifiably	negative
guidance	positive
pillory	negative
shocked	negative
erratic	negative
miscalculate	negative
in	positive
smear	negative
astutely	positive
notably	positive
ironically	negative
fanatically	negative
unsuccessful	negative
appearance	negative
irksomely	negative
inconsolably	negative
dogged	negative
creeping	negative
cold	negative
sentence	negative
egotistically	negative
diabolical	negative
pedantic	negative
head-aches	negative
listless	negative
Negative	negative
apologists	negative
cramp	negative
rumors	negative
golden	positive
bully	negative
irreparable	negative
liberate	positive
scrambles	negative
job-killing	negative
narrower	negative
glitter	positive
Liu.	positive
celebrate	positive
desiccate	negative
words	positive
redundancy	negative
gooood	positive
sloww	negative
irrationally	negative
sharper	positive
sweetness	positive
hassle	negative
outshone	positive
ridicule	negative
snarky	negative
distract	negative
succeeded	positive
venomous	negative
carp	negative
easier	positive
dumping	negative
cheat	negative
reputation	positive
incommensurate	negative
cheated	negative
haste	negative
frightening	negative
beauty	positive
exultingly	positive
insufferable	negative
ill-natured	negative
zombie	negative
staunchness	positive
disorient	negative
2005,	positive
paupers	negative
life-threatening	negative
glow	positive
diss	negative
swollen	negative
arrogance	negative
paper	positive
precipitate	negative
aspiration	positive
constructive	positive
brazenness	negative
affably	positive
alarm	negative
mania	negative
disintegration	negative
deject	negative
nourishment	positive
disconsolately	negative
anemic	negative
notorious	negative
distasteful	negative
spoonfed	negative
cruelness	negative
loathsomely	negative
detestable	negative
thankless	negative
villianously	negative
bait	negative
levity	positive
disturbing	negative
dawn	positive
beautiful	positive
irksomenesses	negative
encroach	negative
impede	negative
abominable	negative
insecure	negative
2010.	negative
amazed	positive
corrupting	negative
adventurous	positive
obstinately	negative
enviable	positive
dubiously	negative
immovable	negative
relaxed	positive
sass	negative
supportive	positive
forsake	negative
unnecessary	negative
thrill	positive
overdue	negative
hated	negative
appear	positive
worthlessly	negative
fanfare	positive
shallow	negative
flair	negative
unbiased	positive
smutty	negative
doomsday	negative
courageously	positive
coercive	negative
depressed	negative
strictly	negative
absentee	negative
unsteadiness	negative
curses	negative
deadly	negative
commitment	positive
randomly	negative
threesome	negative
elegant	positive
enchanted	positive
imbalance	negative
self-sufficiency	positive
generously	positive
effusive	positive
nightmare	negative
heckle	negative
engrossing	positive
annihilate	negative
injury	negative
praise	positive
subservient	negative
fatal	negative
ambivalence	negative
demeaning	negative
crook	negative
misbegotten	negative
delicious	positive
mesmerizing	positive
craze	negative
traction	positive
panicky	negative
gush	positive
moody	negative
shimmering	positive
impassioned	positive
incessant	negative
intriguing	positive
provocative	negative
dogmatic	negative
embroilment	negative
sinfully	negative
breathtakingly	positive
cannibal	negative
exhaustion	negative
fine-looking	positive
assure	positive
stifling	negative
flickering	negative
repress	negative
loathly	negative
shatter	negative
implausible	negative
agilely	positive
burning	negative
unresponsive	negative
disdainful	negative
dud	negative
unconvincing	negative
exceled	positive
mashed	negative
irreplaceable	positive
jolt	negative
embroiled	negative
jam	negative
prejudge	negative
J.	positive
dislocated	negative
incomplete	negative
uncompromising	negative
unsettled	negative
rejoicingly	positive
skillful	positive
sloppily	negative
disagreeably	negative
inconceivable	negative
disquietude	negative
tyrannically	negative
illuminati	positive
suicidal	negative
vengeful	negative
contemptuously	negative
calamities	negative
remarkable	positive
blurs	negative
remarkably	positive
harangue	negative
harassment	negative
radicalization	negative
scuff	negative
boost	positive
stubborn	negative
malady	negative
hypocrite	negative
crappy	negative
inept	negative
tricky	negative
complaining	negative
Handbook	positive
wiles	negative
sugar-coat	negative
disappointed	negative
obese	negative
misjudge	negative
soapy	negative
demoralize	negative
degenerately	negative
outlaw	negative
impetuously	negative
hardened	negative
phobia	negative
comfy	positive
heavenly	positive
pains	negative
deceitfully	negative
thug	negative
jaw-droping	positive
critic	negative
revengeful	negative
impressive	positive
gawk	negative
unauthentic	negative
lapsed	negative
murderously	negative
showdown	negative
stylish	positive
downgrade	negative
barren	negative
mortified	negative
ill-treatment	negative
hooray	positive
desolately	negative
bellicose	negative
refunded	positive
Natural	negative
conspicuously	negative
privilege	positive
nourishing	positive
emaciated	negative
militancy	negative
nauseate	negative
of	positive
unproven	negative
eminent	positive
decry	negative
cheer	positive
attentive	positive
top	positive
quandary	negative
best	positive
refresh	positive
flakieness	negative
adulation	positive
vociferous	negative
obstructing	negative
slut	negative
insolence	negative
utterly	negative
damnation	negative
nasty	negative
dodgey	negative
appealing	positive
travesty	negative
struck	negative
obstinate	negative
disputed	negative
dishonest	negative
distressed	negative
embattled	negative
inflammed	negative
uncivil	negative
stymied	negative
rotten	negative
languorous	negative
fake	negative
blissfully	positive
leech	negative
conceit	negative
unaffected	positive
afford	positive
sacrificed	negative
wickedness	negative
straggle	negative
irritably	negative
infamously	negative
advantageously	positive
pariah	negative
belated	negative
grievously	negative
http://www.cs.uic.edu/~liub/FBS/sentiment-analysis.html	negative
inferiority	negative
flaw	negative
flak	negative
alarming	negative
Processing,	positive
suicide	negative
freezes	negative
bonus	positive
judders	negative
smack	negative
credible	positive
costlier	negative
ardent	positive
unaccustomed	negative
a	negative
many	negative
dejectedly	negative
calamitously	negative
slug	negative
trample	negative
occluded	negative
inhospitable	negative
irrelevant	negative
assurances	positive
douchbag	negative
self-sufficient	positive
inadequately	negative
uneasily	negative
slave	negative
broken-hearted	negative
content.	positive
grumpily	negative
progress	positive
non-violent	positive
unassailable	positive
dismaying	negative
messed	negative
rail	negative
sugarcoated	negative
spurn	negative
vindictiveness	negative
Liu,	negative
mistakenly	negative
hoax	negative
hurt	negative
crisis	negative
inhospitality	negative
harmonize	positive
unhappiness	negative
integrated	positive
depressions	negative
extinguish	negative
miss	negative
feign	negative
fallen	negative
disorder	negative
detachable	positive
letch	negative
scummy	negative
contagious	negative
intrusive	negative
unpleasantries	negative
timidly	negative
refuted	negative
scary	negative
grim	negative
spoils	negative
oddity	negative
intimacy	positive
dragging	negative
glut	negative
humility	positive
sweet	positive
Indurkhya	positive
tenaciously	positive
frigging	negative
despairing	negative
noisier	negative
rhetoric	negative
ridiculous	negative
aspire	positive
adoring	positive
frenetically	negative
fateful	negative
disapproval	negative
wicked	negative
Junsheng	negative
immature	negative
aggrieved	negative
instigators	negative
considerate	positive
refund	positive
villainous	negative
Proceedings	negative
stellarly	positive
heartily	positive
smart	positive
abounds	positive
preeminent	positive
scandals	negative
implicate	negative
fabrication	negative
mystery	negative
generosity	positive
unkindly	negative
everlasting	positive
disgustingly	negative
fracture	negative
opinion.	negative
frighten	negative
misrepresent	negative
addicted	negative
superior	positive
smoothes	positive
madly	negative
succumb	negative
overpaid	negative
issues	negative
inconsequent	negative
calming	positive
pitiful	negative
the	positive
miserably	negative
inexperienced	negative
miraculousness	positive
madder	negative
zaps	negative
Knowledge	positive
startle	negative
sin	negative
indecision	negative
cautionary	negative
embarrassment	negative
aver	positive
facetiously	negative
maladjustment	negative
enrage	negative
hysterically	negative
creak	negative
bullyingly	negative
scapegoat	negative
thirst	negative
obscenity	negative
reviled	negative
lawbreaker	negative
agreeableness	positive
inexpensive	positive
convenient	positive
dismally	negative
protection	positive
overpower	negative
thoughtlessness	negative
skinny	negative
heroically	positive
polarisation	negative
streamlined	positive
untrue	negative
exorbitant	negative
regrettable	negative
redundant	negative
energize	positive
ordeal	negative
forbidding	negative
exemplar	positive
abound	positive
extort	negative
drop-outs	negative
mismanage	negative
tarnish	negative
shameless	negative
evocative	positive
enraptured	positive
supremely	positive
cost-effective	positive
dazzled	positive
lamentable	negative
pointlessly	negative
fall	negative
low-risk	positive
infringements	negative
exhaust	negative
pleases	positive
steady	positive
precipitous	negative
fleer	negative
surmount	positive
self-humiliation	negative
enticingly	positive
scoff	negative
troublingly	negative
deprecate	negative
contaminate	negative
childish	negative
merriness	positive
frustration	negative
miscellaneous	negative
foolishness	negative
over-hyped	negative
elated	positive
mock	negative
wimpy	negative
promptly	positive
cloudy	negative
neatly	positive
scramble	negative
suffices	positive
infuriate	negative
oppose	negative
skulk	negative
sucky	negative
foremost	positive
shiny	positive
smartest	positive
rupture	negative
demean	negative
outstandingly	positive
;	negative
unusably	negative
crumbling	negative
spitefully	negative
odor	negative
outraged	negative
overbalanced	negative
irrepressible	negative
inflated	negative
haunting	negative
insufferably	negative
dismal	negative
light-hearted	positive
irritant	negative
shamelessness	negative
slogging	negative
confused	negative
debt	negative
indecently	negative
slander	negative
discontented	negative
berserk	negative
hospitable	positive
lifeless	negative
snappishly	negative
insufficiently	negative
exasperatingly	negative
hassled	negative
overtaking	positive
accurately	positive
invidiously	negative
inconsistency	negative
phenomenally	positive
disturbingly	negative
banish	negative
satisfied	positive
encouraging	positive
congratulation	positive
satisfactory	positive
trouble	negative
miff	negative
N.	positive
bewail	negative
messing	negative
god-awful	negative
visionary	positive
direness	negative
positive	positive
conscientious	positive
finer	positive
flickers	negative
bereave	negative
fastuous	negative
yawn	negative
enviously	positive
fairly	positive
gentlest	positive
rant	negative
clever	positive
(editors:	positive
disadvantageous	negative
unproving	negative
incautious	negative
funnily	negative
masterful	positive
master	positive
threatening	negative
merry	positive
back-woods	negative
sufficient	positive
shimmy	negative
debaser	negative
nervousness	negative
grainy	negative
insignificance	negative
brightest	positive
needlessly	negative
discord	negative
infirm	negative
unviewable	negative
in	positive
sufferer	negative
weakness	negative
exagerated	negative
funky	negative
excallent	positive
slashing	negative
splendor	positive
brand-new	positive
rattles	negative
heros	positive
;;;;;;;;;;;;;;;;;;;;;;;;;;;;;;;;;;;;;;;;;;;;;;;;;;;;;;;;;;;;;;;;;;;;;;;;;;;;;;	negative
tumbled	negative
deviate	negative
feasible	positive
sensitive	positive
Analysis	negative
crisp	positive
smilingly	positive
mistrustful	negative
fascism	negative
terrific	positive
bugs	negative
venom	negative
flaunt	negative
rampant	negative
refined	positive
decrement	negative
jubilantly	positive
contrive	negative
exciting	positive
concessions	negative
miserableness	negative
endanger	negative
displeasure	negative
proven	positive
dissatisfaction	negative
delay	negative
chivalry	positive
bloom	positive
condescension	negative
slogged	negative
swanky	positive
unfeeling	negative
wow	positive
qualified	positive
hapless	negative
ire	negative
defunct	negative
Positive	positive
douchebags	negative
mystify	negative
suave	positive
led	positive
languor	negative
infest	negative
hoodwink	negative
auspicious	positive
buggy	negative
siege	negative
short-lived	negative
irritated	negative
romanticize	positive
bleeding	negative
untested	negative
regretful	negative
excessively	negative
moot	negative
vainly	negative
award	positive
commend	positive
timidness	negative
accusation	negative
gimmicks	negative
enslave	negative
maledict	negative
nurturing	positive
sobering	negative
laconic	negative
words).	positive
talents	positive
worsening	negative
toughest	positive
menial	negative
suppress	negative
eschew	negative
distinguished	positive
laughingstock	negative
impersonal	negative
uneven	negative
cite	negative
brood	negative
insanely	negative
tout	negative
intractable	negative
perversion	negative
wallow	negative
terror-genic	negative
Proceedings	positive
demoralizingly	negative
guile	negative
nice	positive
elevate	positive
humiliation	negative
blaspheme	negative
somber	negative
denied	negative
compactly	positive
social	negative
frigid	negative
taunt	negative
cleared	positive
whining	negative
glare	negative
bungling	negative
provocation	negative
nauseating	negative
fatigued	negative
sinisterly	negative
excelled	positive
lose	negative
;	negative
harshly	negative
eye-catching	positive
cripple	negative
audaciousness	negative
twinkly	positive
wrangle	negative
vile	negative
slow	negative
tetchy	negative
sarcastic	negative
fractiously	negative
inaccuracy	negative
undercuts	negative
achievements	positive
interruption	negative
delirium	negative
dishearteningly	negative
spellbind	positive
success	positive
impediment	negative
merrily	positive
foe	negative
wisdom	positive
garbage	negative
heroic	positive
defiler	negative
ennoble	positive
insincere	negative
fooled	negative
reform	positive
ill-used	negative
plotters	negative
likable	positive
threat	negative
anti-us	negative
ruffle	negative
sullen	negative
negligent	negative
intense	negative
shrug	negative
inspire	positive
undisputed	positive
misinform	negative
dying	negative
egregious	negative
hurted	negative
amazement	positive
motionless	negative
harassed	negative
stereotypical	negative
dissing	negative
gasp	negative
altruistic	positive
nicer	positive
villains	negative
relief	positive
contradiction	negative
advocated	positive
speedy	positive
inconstant	negative
renowned	positive
besmirch	negative
bewilderingly	negative
tenacity	positive
conservative	negative
stammer	negative
numb	negative
erratically	negative
upgradeable	positive
perturb	negative
pokey	negative
discomfit	negative
discourteous	negative
peevishly	negative
conspiratorial	negative
lacked	negative
deter	negative
mercifully	positive
undercut	negative
picketing	negative
reaffirm	positive
tramp	negative
hates	negative
Notes:	negative
difficulties	negative
cave	negative
shocking	negative
underdog	negative
ruined	negative
profanity	negative
infidels	negative
cuplrit	negative
severe	negative
doomed	negative
slowest	negative
depression	negative
prefer	positive
throbbing	negative
sagacity	positive
throb	negative
irate	negative
discontent	negative
faster	positive
gritty	negative
paralyzed	negative
fickle	negative
recoil	negative
antagonize	negative
attune	positive
decadent	negative
shimmeringly	positive
jubilant	positive
lurch	negative
betray	negative
ilu	positive
quicker	positive
bust	negative
spews	negative
betrayals	negative
raving	negative
multi-purpose	positive
darker	negative
;	negative
arrogantly	negative
shipwreck	negative
vibrate	negative
calumniation	negative
rattle	negative
disinclined	negative
jutter	negative
shortness	negative
disadvantage	negative
acrimony	negative
despondent	negative
sloth	negative
detrimental	negative
fervently	positive
eminence	positive
dissatisfies	negative
inpressed	positive
sadly	negative
dead	negative
sadden	negative
inarticulate	negative
spoil	negative
unleash	negative
secure	positive
defective	negative
break-ups	negative
disunity	negative
preposterously	negative
rockstars	positive
the	negative
pratfall	negative
maltreatment	negative
graft	negative
jarring	negative
stuffy	negative
enviously	negative
leakages	negative
concise	positive
USA,	positive
luster	positive
coolest	positive
reprehensive	negative
admonisher	negative
belittle	negative
catastrophic	negative
delusion	negative
inimically	negative
facilitate	positive
fluster	negative
impossibly	negative
fleed	negative
trapped	negative
absent-minded	negative
pugnacious	negative
election-rigger	negative
defile	negative
ragged	negative
disquiet	negative
indiscretion	negative
enrapture	positive
hallmarks	positive
ftw	positive
exceptionally	positive
upscale	positive
clean	positive
adulterier	negative
beneficiary	positive
stagnate	negative
does	positive
gossip	negative
stuttering	negative
disavow	negative
supported	positive
mope	negative
list,	positive
gibberish	negative
cleanest	positive
zippy	positive
left-leaning	negative
painless	positive
crime	negative
inadequacy	negative
snare	negative
fathomless	negative
farcical-yet-provocative	negative
gruesomely	negative
mushy	negative
fell	negative
contentious	negative
dissonance	negative
macabre	negative
nefariously	negative
disoobedient	negative
mistified	negative
imprecate	negative
sluts	negative
disavowal	negative
misaligned	negative
restructured	positive
unlamentable	negative
of	negative
delusions	negative
scaly	negative
satisfies	positive
rapt	positive
concens	negative
two-faces	negative
worriedly	negative
complication	negative
self-determination	positive
dunce	negative
inexcusably	negative
poised	positive
plaything	negative
intoxicate	negative
falter	negative
hegemonistic	negative
assault	negative
worthlessness	negative
ghastly	negative
derogatory	negative
serene	positive
conflicted	negative
begging	negative
cheating	negative
list.	positive
Liu.	positive
shake	negative
powerful	positive
F.	positive
expresses	positive
creative	positive
and	negative
balanced	positive
hairloss	negative
nimble	positive
emphatically	negative
powerless	negative
genocide	negative
grudges	negative
swiftness	positive
enticed	positive
appeal	positive
struggles	negative
smiles	positive
biased	negative
insolently	negative
consternation	negative
snarl	negative
dispensable	negative
standstill	negative
violation	negative
forceful	negative
disgruntle	negative
doubtfully	negative
unpredictable	negative
infallibility	positive
madman	negative
ridicules	negative
fantastic	positive
conference	negative
weaker	negative
a	negative
madness	negative
righteously	positive
swift	positive
breaking	negative
disloyalty	negative
tiring	negative
the	negative
prattle	negative
commonplace	negative
keenness	positive
outrages	negative
1.	negative
antiquated	negative
aggravation	negative
unsound	negative
worthless	negative
bewitch	negative
sickeningly	negative
confusions	negative
hollow	negative
inaction	negative
bombard	negative
tougher	positive
hallmark	positive
snag	negative
squealing	negative
gracelessly	negative
burdensome	negative
grudge	negative
Web."	positive
blindingly	negative
appreciates	positive
insupportable	negative
well-regarded	positive
advocate	positive
Liu.	negative
complaints	negative
stumped	negative
flare	negative
famous	positive
hastily	negative
quarrelsome	negative
subservience	negative
pampers	positive
peril	negative
trashed	negative
happiness	positive
downcast	negative
congratulate	positive
whiny	negative
soothingly	positive
contortions	negative
glad	positive
Japan.	positive
ingenuously	positive
impatiently	negative
scorchingly	negative
emergency	negative
spilling	negative
undisputably	positive
taunts	negative
latency	negative
quack	negative
admirably	positive
pervert	negative
trauma	negative
objectionable	negative
frantically	negative
miserable	negative
graciously	positive
productive	positive
wildly	negative
meticulous	positive
offensively	negative
monumentally	positive
prolific	positive
panic	negative
repressive	negative
energy-efficient	positive
thumb-down	negative
adaptable	positive
defiantly	negative
prevaricate	negative
passe	negative
junkyard	negative
crushed	negative
exuberance	positive
calumnies	negative
worsen	negative
succeeding	positive
slumping	negative
convincing	positive
exaltingly	positive
proves	positive
healthful	positive
pepped	positive
improvements	positive
positive	positive
oblique	negative
pertinacious	negative
fat	negative
ill-conceived	negative
mess	negative
combative	negative
assuredly	positive
malevolence	negative
are	positive
haggard	negative
fustigate	negative
forfeit	negative
sincere	positive
dense	negative
limp	negative
despondently	negative
inequitable	negative
eloquently	positive
egocentric	negative
gratifying	positive
execrate	negative
vouch	positive
scarce	negative
riled	negative
irrationality	negative
rock-star	positive
offending	negative
"Mining	negative
unjustly	negative
illustrious	positive
criticized	negative
deadweight	negative
tanked	negative
over-balanced	negative
fever	negative
serenity	positive
buzzing	negative
hell	negative
of	negative
problematic	negative
;	negative
wrinkles	negative
encroachment	negative
effectively	positive
prowess	positive
acerbate	negative
virus	negative
bitter	negative
monotonous	negative
distrust	negative
strangely	negative
pity	negative
shoddy	negative
overtook	positive
deaf	negative
breathtaking	positive
inconceivably	negative
expensive	negative
unequal	negative
downturn	negative
clunky	negative
scandalize	negative
misfortune	negative
ingrate	negative
ultimatums	negative
blatant	negative
inconsiderate	negative
endear	positive
overtake	positive
garish	negative
smallish	negative
immobilized	negative
wretched	negative
huckster	negative
are	positive
appalled	negative
hasty	negative
exclusion	negative
opposition	negative
misdirection	negative
bicker	negative
distraught	negative
dispute	negative
humorously	positive
maturely	positive
shine	positive
thwart	negative
audacity	negative
detest	negative
slaves	negative
perfection	positive
effectiveness	positive
baffle	negative
shrew	negative
of	positive
Liu.	negative
consistent	positive
outperform	positive
heavy-handed	negative
drawbacks	negative
blackmail	negative
gaffe	negative
ambiguous	negative
jovial	positive
sumptuous	positive
dignity	positive
well-established	positive
optimism	positive
are	negative
protesting	negative
incompetence	negative
repudiation	negative
limited	negative
subvert	negative
intimidatingly	negative
backwardness	negative
mistrustfully	negative
assassin	negative
affluent	positive
manageable	positive
trusty	positive
love	positive
incendiary	negative
one-sided	negative
harmoniously	positive
dismissively	negative
snobby	negative
teasingly	negative
panoramic	positive
craps	negative
thoughtless	negative
miracle	positive
richly	positive
sues	negative
drunken	negative
ache	negative
goodwill	positive
poverty	negative
robust	positive
intermittent	negative
unorthodoxy	negative
law-abiding	positive
thankful	positive
delinquency	negative
dissed	negative
hottest	positive
sham	negative
lawfully	positive
indifference	negative
bum	negative
little-known	negative
opinionated	negative
turmoil	negative
lawbreaking	negative
rile	negative
grumble	negative
proper	positive
bullshyt	negative
trouble-free	positive
unnerve	negative
stingy	negative
cheaper	positive
brazen	negative
marvelled	positive
consummate	positive
proficient	positive
available	positive
strident	negative
stunted	negative
smoulder	negative
self-serving	negative
chill	negative
unfulfilled	negative
encouragingly	positive
distrusting	negative
fatally	negative
sunder	negative
top-notch	positive
nosey	negative
picket	negative
smug	negative
cure	positive
disparagingly	negative
inopportune	negative
distraction	negative
kindly	positive
distress	negative
creaks	negative
gaining	positive
censure	negative
benevolence	positive
dazed	negative
in	negative
deceit	negative
included	negative
hater	negative
mighty	positive
disdainfully	negative
ungovernable	negative
gloatingly	negative
bafflement	negative
morbid	negative
trap	negative
beneficial	positive
fruitful	positive
martyrdom	negative
enthusiastic	positive
afflictive	negative
denies	negative
crashing	negative
unrelentingly	negative
imprisonment	negative
anger	negative
mischievously	negative
direly	negative
hogs	negative
rip	negative
unreasonable	negative
nefarious	negative
demolisher	negative
exult	positive
conflict	negative
rusty	negative
exquisite	positive
debasement	negative
eases	positive
and	negative
unscrupulously	negative
vagrant	negative
tainted	negative
preferable	positive
mistakes.	positive
trick	negative
bungler	negative
haters	negative
neglect	negative
contains	positive
foully	negative
tortured	negative
disapproving	negative
fearless	positive
personages	positive
will	positive
hells	negative
sardonically	negative
apotheosis	positive
illuminating	positive
unmoved	negative
stooges	negative
exaggerate	negative
suffering	negative
lustrous	positive
gruesome	negative
believeable	positive
stereotypically	negative
taboo	negative
disoriented	negative
goood	positive
agreeably	positive
unorthodox	negative
fearful	negative
belie	negative
gaiety	positive
profoundly	positive
deteriorate	negative
lame-duck	negative
individualized	positive
fret	negative
insulting	negative
nastily	negative
masterpiece	positive
impresses	positive
reasonable	positive
punitive	negative
slogs	negative
violator	negative
astonishment	positive
violators	negative
idiotic	negative
important	positive
undamaged	positive
despair	negative
stainless	positive
unclean	negative
advocates	positive
defeating	positive
lovelorn	negative
insinuation	negative
ranting	negative
disable	negative
stabilize	positive
vent	negative
sugar-coated	negative
dope	negative
disconcerting	negative
glaringly	negative
assurance	positive
futilely	negative
discontinuity	negative
swankier	positive
ultra-crisp	positive
f**k	negative
apprehensive	negative
strife	negative
exorbitantance	negative
snobs	negative
glee	positive
frost	negative
disheartening	negative
lumpy	negative
rollercoaster	negative
martyrdom-seeking	negative
inefficacious	negative
amity	positive
and	positive
alluring	positive
destiny	positive
affectionate	positive
amicability	positive
paltry	negative
raping	negative
self-interested	negative
admonish	negative
deadbeat	negative
irredeemable	negative
acrimonious	negative
downhill	negative
correct	positive
simplistically	negative
mawkishly	negative
calmness	positive
unproves	negative
traumatize	negative
injustices	negative
fatcats	negative
cranky	negative
gumption	positive
lowly	negative
sickening	negative
outdone	positive
dissidence	negative
hands-down	positive
diversified	positive
http://www.cs.uic.edu/~liub/FBS/sentiment-analysis.html	positive
exacerbate	negative
favor	positive
sagging	negative
revolutionary	positive
ill-fated	negative
scariest	negative
of	positive
demolish	negative
tops	positive
incompatibility	negative
noisy	negative
whores	negative
instrumental	positive
endorsed	positive
liked	positive
inequities	negative
shadowy	negative
grisly	negative
fame	positive
allergy	negative
denial	negative
heck	negative
cure-all	positive
glowingly	positive
downfallen	negative
elan	positive
steadfastness	positive
bemoaning	negative
rantingly	negative
inspirational	positive
richer	positive
wondrous	positive
friendly	positive
evasive	negative
blatantly	negative
righteous	positive
intolerablely	negative
influential	positive
debility	negative
ineffectiveness	negative
concern	negative
burns	negative
smash	negative
stimulates	positive
ghetto	negative
ridiculously	negative
stupidest	negative
chastisement	negative
uncontrolled	negative
spellbindingly	positive
furor	negative
exhilarate	positive
alarmed	negative
edify	positive
delicacy	positive
lone	negative
hilarious	positive
alienation	negative
disgraced	negative
hopeful	positive
disvalue	negative
awesomely	positive
inanely	negative
mindless	negative
racism	negative
detraction	negative
punish	negative
defamatory	negative
unproductive	negative
remorseless	negative
fondness	positive
afordable	positive
rewarding	positive
irresistibly	positive
exhort	negative
enrich	positive
straighten	positive
unaccessible	negative
curt	negative
rebuff	negative
skeptical	negative
harmony	positive
vivacious	positive
foulness	negative
traumatic	negative
ingenuity	positive
clouding	negative
farce	negative
abysmal	negative
blameworthy	negative
sneering	negative
pry	negative
;	positive
humane	positive
confessions	negative
steal	negative
fascinating	positive
timid	negative
grumpier	negative
greatest	positive
unity	positive
astoundingly	positive
expunge	negative
fretful	negative
wayward	negative
taut	negative
hatefulness	negative
malignant	negative
fervidly	positive
nobly	positive
Japan.	negative
skepticism	negative
pre-eminent	positive
handsome	positive
erroneous	negative
impetuous	negative
disagree	negative
flawlessly	positive
skeptic	negative
adorable	positive
wreaked	negative
immoral	negative
engulf	negative
fundamentalism	negative
partisans	negative
Wide	negative
rebellious	negative
oblivious	negative
fallacy	negative
innovative	positive
inefficiently	negative
maliciously	negative
partisan	negative
chunky	negative
slump	negative
devilishly	negative
weaken	negative
belabor	negative
avariciously	negative
contrasty	positive
inestimable	positive
intelligible	positive
bitterness	negative
sufficiently	positive
Customer	positive
supurbly	positive
yay	positive
noiseless	positive
2.	negative
tacky	negative
invaluable	positive
immorality	negative
ignorant	negative
untrustworthy	negative
neglected	negative
infected	negative
inadvisable	negative
excuses	negative
impeccable	positive
spinster	negative
well-positioned	positive
altercation	negative
issue	negative
absurdity	negative
misjudgment	negative
gape	negative
obsolete	negative
loved	positive
flimsy	negative
deploringly	negative
unsavory	negative
unwell	negative
miscreants	negative
sickly	negative
stressful	negative
Minqing	negative
undignified	negative
Subjectivity."	negative
bent	negative
electrify	positive
upbraid	negative
splendidly	positive
squirm	negative
sporadic	negative
cracks	negative
stolen	negative
faze	negative
roomy	positive
unfaithful	negative
defects	negative
avaricious	negative
derisively	negative
impure	negative
upbeat	positive
questionable	negative
abscond	negative
readily	positive
pettifog	negative
confuses	negative
freak	negative
flee	negative
biases	negative
subjugate	negative
apprehension	negative
and	positive
fascinate	positive
stubbornly	negative
piety	positive
miseries	negative
clearer	positive
flashy	positive
deprived	negative
Reviews."	positive
reckless	negative
paucity	negative
SIGKDD	positive
haphazard	negative
interests	positive
crooked	negative
reject	negative
perplex	negative
Indurkhya	negative
lure	negative
downhearted	negative
Natural	positive
misbehave	negative
plebeian	negative
thrilled	positive
quiet	positive
sentiment	negative
incorrigible	negative
inadverent	negative
loopholes	negative
;	negative
unforgiving	negative
condescend	negative
fancinating	positive
dismalness	negative
sting	negative
wonderful	positive
lamentably	negative
downturns	negative
guiltily	negative
diligence	positive
impair	negative
comfort	positive
impressively	positive
overpriced	negative
prodigious	positive
user-friendly	positive
douchebag	negative
idiocy	negative
bothers	negative
gallant	positive
grievances	negative
prosper	positive
glitches	negative
sumptuously	positive
estranged	negative
aloof	negative
ploy	negative
conciliate	positive
of	positive
wieldy	positive
unqualified	negative
beckoning	positive
misery	negative
objections	negative
fanatics	negative
ill-defined	negative
usurper	negative
thumb-up	positive
fearlessly	positive
disapointed	negative
scornful	negative
grievance	negative
reforming	positive
subdued	negative
obtuse	negative
holy	positive
fecilitous	positive
exaltation	positive
scoffingly	negative
upsetting	negative
deceitful	negative
wheedle	negative
idiocies	negative
stable	positive
drastically	negative
words	negative
equivocal	negative
mar	negative
See	negative
vulnerable	negative
masters	positive
culpable	negative
phobic	negative
hinder	negative
joyous	positive
rue	negative
intuitive	positive
grating	negative
willingly	positive
vehement	negative
fortitude	positive
impressed	positive
thrills	positive
successes	positive
unjust	negative
securely	positive
mordant	negative
wretch	negative
;	positive
leads	positive
elegantly	positive
coward	negative
mendacity	negative
idle	negative
lush	positive
better	positive
superficial	negative
poorest	negative
liberation	positive
an	negative
braggart	negative
momentous	positive
shortage	negative
accomplished	positive
irking	negative
debauchery	negative
enthuse	positive
resounding	positive
providence	positive
blemish	negative
uproarious	negative
incompatible	negative
detested	negative
disconcert	negative
atrophy	negative
precise	positive
ease	positive
hallucinate	negative
undocumented	negative
comical	negative
pernicious	negative
marvelous	positive
thoughtlessly	negative
cooperatively	positive
unreachable	negative
shriek	negative
richness	positive
upliftingly	positive
disturb	negative
pickets	negative
unnerved	negative
striking	positive
busts	negative
fulfillment	positive
hamper	negative
desolate	negative
impossible	negative
rosy	positive
(editors:	negative
sensation	positive
affability	positive
charmingly	positive
fearsome	negative
backward	negative
winner	positive
accusations	negative
1.	positive
magnanimous	positive
omit	negative
peerless	positive
undermined	negative
fatigue	negative
venomously	negative
misapprehend	negative
wonderous	positive
testy	negative
tickle	positive
distracting	negative
gorgeously	positive
loath	negative
destitute	negative
dauntless	positive
brainless	negative
inequalities	negative
;	negative
inflame	negative
unraveled	negative
distinction	positive
persevere	positive
irreconcilable	negative
enviousness	negative
mediocrity	negative
shabby	negative
ineptitude	negative
ill-sorted	negative
longing	negative
insulted	negative
unhappy	negative
involuntary	negative
2-faces	negative
unlicensed	negative
delightfully	positive
dislikes	negative
poorer	negative
lied	negative
nepotism	negative
rremediable	negative
angry	negative
tedious	negative
regret	negative
abnormal	negative
opulent	positive
bump	negative
treasure	positive
needy	negative
retards	negative
missed	negative
illegally	negative
splatter	negative
haunt	negative
complicated	negative
laughable	negative
optimal	positive
agony	negative
well-received	positive
you	negative
revolt	negative
jealously	negative
Bing	negative
Data	negative
addicting	negative
relent	positive
so-cal	negative
dissenter	negative
trumpet	positive
deprive	negative
flat-out	negative
kill	negative
grumpish	negative
malodorous	negative
dusty	negative
prefers	positive
festive	positive
nicely	positive
irksome	negative
evils	negative
emasculate	negative
vibrates	negative
slow-moving	negative
uplifting	positive
amiable	positive
virulence	negative
disingenuously	negative
loss	negative
in	negative
interrupt	negative
berate	negative
inconsolable	negative
drought	negative
allergies	negative
unbeatable	positive
dissocial	negative
gloom	negative
groundbreaking	positive
declining	negative
problem-free	positive
lovable	positive
mourner	negative
scratches	negative
deplorable	negative
meanness	negative
collude	negative
castigate	negative
hawkish	negative
well-educated	positive
well-mannered	positive
excites	positive
condemn	negative
humiliate	negative
undercutting	negative
grouchy	negative
mesmerizingly	positive
traduce	negative
exceeding	positive
aggressor	negative
desiring	positive
prize	positive
destitution	negative
stranger	negative
uglier	negative
awsome	positive
lost	negative
exaltedly	positive
fabricate	negative
distastefully	negative
high-quality	positive
mindlessly	negative
hothouse	negative
prompt	positive
gallingly	negative
agreeable	positive
pitiless	negative
imperious	negative
clogs	negative
irascible	negative
encouragement	positive
shamelessly	negative
adversarial	negative
tentatively	negative
brilliances	positive
ail	negative
haughty	negative
invalidity	negative
gratifyingly	positive
anti-white	negative
plight	negative
diplomatic	positive
remunerate	positive
brotherly	positive
tyranny	negative
fine	positive
desperate	negative
reaffirmation	positive
silent	positive
feverish	negative
outrageousness	negative
declaim	negative
awesome	positive
recommend	positive
get-rich	negative
;	positive
;	positive
noises	negative
blunders	negative
freshest	positive
papers:	positive
lunatic	negative
faithless	negative
conflicts	negative
hothead	negative
scum	negative
object	negative
mirage	negative
vexingly	negative
freedom	positive
the	negative
discrimination	negative
retractable	positive
breaks	negative
standout	positive
rigidness	negative
clogged	negative
retaliatory	negative
disquietingly	negative
Notes:	positive
fat-cats	negative
shortsighted	negative
setbacks	negative
unwavering	positive
betraying	negative
volatility	negative
enjoyably	positive
polluters	negative
degenerate	negative
murderous	negative
appreciable	positive
unpopular	negative
galls	negative
idiots	negative
civility	positive
disintegrated	negative
enhances	positive
retardedness	negative
malcontented	negative
sustainability	positive
10-14,	negative
mundane	negative
misguide	negative
blabber	negative
plunder	negative
overact	negative
hung	negative
petty	negative
insolvent	negative
examplary	positive
regreted	negative
cynical	negative
inelegant	negative
uncivilized	negative
motley	negative
spiteful	negative
obscenely	negative
tangle	negative
warmhearted	positive
overzelous	negative
lavishly	positive
uneconomical	negative
resentment	negative
undersized	negative
outperforming	positive
spooky	negative
Minqing	positive
enthralled	positive
neat	positive
damnably	negative
ingenious	positive
counter-productive	negative
rapid	positive
dominates	positive
marvelously	positive
warily	negative
social	positive
craftily	negative
bullshit	negative
triumphantly	positive
(WWW-2005),	positive
adore	positive
indulgence	positive
profuse	positive
envy	positive
stress	negative
anti-social	negative
multi-polarization	negative
break-up	negative
heartwarming	positive
depressing	negative
mean	positive
2010.	positive
examplar	positive
excels	positive
excellant	positive
disloyal	negative
Web	negative
prick	negative
;	positive
inaptitude	negative
freakish	negative
concerns	negative
Analyzing	negative
accolades	positive
adroitly	positive
revulsion	negative
overtakes	positive
irked	negative
as	positive
disparaging	negative
limitation	negative
negativity	negative
catastrophically	negative
refused	negative
rejection	negative
navigable	positive
imprecise	negative
exasperation	negative
principled	positive
stricken	negative
lucrative	positive
elation	positive
menacingly	negative
retreated	negative
gaff	negative
unfounded	negative
justly	positive
overawe	negative
uncomfy	negative
overtaken	positive
Language	positive
invalidate	negative
unexplained	negative
weakening	negative
misreading	negative
offensiveness	negative
jitters	negative
ignominious	negative
idyllic	positive
misgiving	negative
harbors	negative
truthful	positive
amicably	positive
thrash	negative
humorous	positive
resplendent	positive
jaw-dropping	positive
clumsy	negative
stiffness	negative
breathlessness	positive
This	positive
idol	positive
exasperating	negative
risks	negative
adoringly	positive
cuss	negative
sick	negative
undetermined	negative
decisive	positive
uninformed	negative
scuffs	negative
credence	positive
doubts	negative
immaculate	positive
dilapidated	negative
deficiencies	negative
infuriating	negative
SIGKDD	negative
indecency	negative
brusque	negative
patriotic	positive
modest	positive
impious	negative
instantly	positive
terror	negative
Hu	negative
heartbreakingly	negative
smoothly	positive
ugliest	negative
relentless	negative
revive	positive
resigned	negative
feeble	negative
languish	negative
indeterminate	negative
dimmer	negative
appreciated	positive
despicably	negative
helping	positive
confession	negative
inclement	negative
bitterly	negative
pure	positive
ambush	negative
indecisively	negative
severity	negative
affirmative	positive
troubling	negative
worth-while	positive
repulsive	negative
hysterics	negative
belittled	negative
unyielding	negative
winners	positive
discontinuous	negative
enticing	positive
inattentive	negative
galore	positive
prejudices	negative
World	positive
cash-strapped	negative
doldrums	negative
best-performing	positive
conspire	negative
peacekeepers	positive
death	negative
afflict	negative
criticisms	negative
diabolically	negative
memorable	positive
fastest-growing	positive
mangled	negative
gorgeous	positive
unprove	negative
benefactor	positive
fastidiously	negative
contemptuous	negative
mediocre	negative
downloaded	positive
refuses	negative
unconfirmed	negative
revoltingly	negative
fleeing	negative
grate	negative
amazingly	positive
perplexed	negative
stylized	positive
pander	negative
blunder	negative
mawkishness	negative
unwilling	negative
inescapably	negative
overrun	negative
flaky	negative
misinterpret	negative
worst	negative
snob	negative
forgetful	negative
clamor	negative
farcically	negative
terribleness	negative
elegance	positive
faithful	positive
spookiest	negative
worrisome	negative
bankrupt	negative
retard	negative
indiscreetly	negative
gimmicky	negative
traitorous	negative
sloppy	negative
in	negative
snagging	negative
accusingly	negative
obstacle	negative
record-setting	positive
malicious	negative
Aug	positive
discoutinous	negative
recover	positive
merit	positive
lazy	negative
lackeys	negative
fascination	positive
impudence	negative
liar	negative
cleanly	positive
or	positive
blockhead	negative
barbarity	negative
Wide	positive
bluring	negative
anxious	negative
cliche	negative
scandels	negative
approve	positive
scarred	negative
majestic	positive
implausibly	negative
irritations	negative
dangerous	negative
;	negative
frantic	negative
;	negative
assassinate	negative
trustworthiness	positive
monstrous	negative
agonies	negative
infraction	negative
dirtbags	negative
defamation	negative
stupor	negative
poisonous	negative
dirt	negative
tumbles	negative
great	positive
scars	negative
virulent	negative
unfavorable	negative
incredible	positive
;;;;;;;;;;;;;;;;;;;;;;;;;;;;;;;;;;;;;;;;;;;;;;;;;;;;;;;;;;;;;;;;;;;;;;;;;;;;	positive
unconditional	positive
baffling	negative
lewd	negative
perseverance	positive
allege	negative
a	positive
perilous	negative
vengeance	negative
meager	negative
ironical	negative
intelligent	positive
impropriety	negative
reconciliation	positive
fanatic	negative
hopeless	negative
(WWW-2005),	negative
unease	negative
invigorate	positive
rectifying	positive
imperfections	negative
arduously	negative
abuses	negative
knock	negative
suspect	negative
and	negative
exonerate	positive
neatest	positive
run-down	negative
credulous	negative
cry	negative
hangs	negative
vigilant	positive
useless	negative
apocalypse	negative
cataclysm	negative
malcontent	negative
harmful	negative
spellbound	positive
starve	negative
the	positive
handier	positive
saggy	negative
well-wishers	positive
baffled	negative
hypocritical	negative
undependability	negative
injurious	negative
skittish	negative
eyesore	negative
powerfully	positive
chapter	positive
resilient	positive
shrill	negative
reproach	negative
thrifty	positive
deceptively	negative
stingingly	negative
stutter	negative
audible	positive
heroize	positive
confounded	negative
ranted	negative
ripped	negative
enjoyed	positive
betrayer	negative
treacherously	negative
revile	negative
defender	positive
sneeringly	negative
pretentiously	negative
cramped	negative
helped	positive
beneficially	positive
full-blown	negative
frustratingly	negative
destroyer	negative
luxuriate	positive
reverence	positive
reputable	positive
crumple	negative
;	positive
inestimably	positive
impaired	negative
lascivious	negative
pricey	negative
bastard	negative
unencumbered	positive
thorny	negative
decisiveness	positive
dick	negative
intransigence	negative
dishonorable	negative
renunciation	negative
grandeur	positive
deterrent	negative
indignantly	negative
underlings	negative
obliterated	negative
revolting	negative
adulterated	negative
hideously	negative
shrilly	negative
impurity	negative
hopelessly	negative
fortuitous	positive
menacing	negative
outsider	negative
dignify	positive
profane	negative
stink	negative
wretchedly	negative
wounds	negative
forbid	negative
wack	negative
exterminate	negative
peculiar	negative
expropriation	negative
excessive	negative
sustainable	positive
drain	negative
wilt	negative
pitifully	negative
dreadfulness	negative
contort	negative
innocuous	positive
catastrophies	negative
lurid	negative
beckoned	positive
acrid	negative
melancholy	negative
;	negative
drag	negative
ebullience	positive
efficacious	positive
over-priced	negative
nettle	negative
lucidly	positive
demonizes	negative
ugliness	negative
disclaim	negative
cohesive	positive
deceiving	negative
renaissance	positive
dispirited	negative
wrestle	negative
mature	positive
bs	negative
drains	negative
crass	negative
jealous	negative
admiringly	positive
lackadaisical	negative
unsatisfactory	negative
complementary	positive
friendliness	positive
thrillingly	positive
itching	negative
pain-free	positive
downheartedly	negative
works	positive
deride	negative
wowing	positive
galling	negative
appallingly	negative
dislike	negative
cloud	negative
stall	negative
meddle	negative
die-hard	negative
destabilisation	negative
eyecatching	positive
rapture	positive
undone	negative
words	negative
casualty	negative
amuse	positive
anguish	negative
soundness	positive
pretend	negative
seethe	negative
willingness	positive
scolding	negative
suspicious	negative
entanglement	negative
verifiable	positive
belligerently	negative
incompetent	negative
drips	negative
fave	positive
overzealously	negative
squabbling	negative
unsuccessfully	negative
clash	negative
supporter	positive
supporting	positive
openness	positive
ineffectually	negative
temptation	negative
unequivocal	positive
relentlessly	negative
writhe	negative
boom	positive
trivial	negative
imprudent	negative
glowing	positive
shiver	negative
stab	negative
goon	negative
bull****	negative
greasy	negative
capable	positive
interference	negative
overwhelming	negative
callous	negative
witty	positive
frets	negative
rejuvenating	positive
oppressive	negative
invigorating	positive
jubilation	positive
not	negative
preposterous	negative
curse	negative
stubbornness	negative
ludicrous	negative
quaint	positive
Summarizing	negative
excitement	positive
insightfully	positive
adamantly	negative
irreproachable	positive
dullard	negative
radicals	negative
benefit	positive
agonize	negative
dashing	positive
frozen	negative
unkind	negative
clear	positive
unavailable	negative
hysteric	negative
obtainable	positive
Analyzing	positive
facetious	negative
disdained	negative
awfully	negative
extol	positive
coerce	negative
indelicate	negative
suffered	negative
continuity	positive
jutters	negative
amenable	positive
aghast	negative
obscene	negative
champ	positive
loser	negative
impatient	negative
gibber	negative
feat	positive
procrastinate	negative
slammin	positive
indefensible	negative
damning	negative
impeccably	positive
spiritless	negative
disillusioned	negative
hardships	negative
optimistic	positive
fleeting	negative
concession	negative
not	positive
limitations	negative
enrapt	positive
split	negative
weariness	negative
adventuresome	positive
disappointingly	negative
ruins	negative
awkwardness	negative
disproportionate	negative
licentious	negative
long-lasting	positive
bribery	negative
frazzle	negative
intransigent	negative
decline	negative
lapse	negative
unhelpful	negative
bashing	negative
relapse	negative
personalized	positive
banishment	negative
selfishness	negative
exultation	positive
Chiba,	positive
contaminates	negative
stumbled	negative
;	positive
headway	positive
prefered	positive
cushy	positive
content.	negative
hard	negative
authentic	positive
fruitlessly	negative
sore	negative
tarnishing	negative
insincerity	negative
merriment	positive
mistakes	negative
incoherence	negative
supurb	positive
pathetically	negative
diligently	positive
travesties	negative
squeaky	negative
goodness	positive
sloooow	negative
vomits	negative
danken	positive
havoc	negative
belligerence	negative
rivalry	negative
felicitate	positive
discouragingly	negative
rigidity	negative
discontentedly	negative
distorts	negative
perversely	negative
strangest	negative
confounding	negative
engaging	positive
perverse	negative
myth	negative
shun	negative
slooow	negative
International	positive
adulterate	negative
pinch	negative
exalting	positive
abysmally	negative
confound	negative
embarrassing	negative
sensationalize	negative
monstrosities	negative
flawed	negative
tenacious	positive
mist	negative
loving	positive
cleaner	positive
oppression	negative
baseless	negative
harboring	negative
pretentious	negative
scarcely	negative
protests	negative
bristle	negative
worthy	positive
durable	positive
dote	positive
Web	positive
euphoria	positive
aborts	negative
insubstantially	negative
injure	negative
recovery	positive
endorsing	positive
brutalising	negative
;	negative
top-heavy	negative
sentence	negative
dead-on	positive
tragedy	negative
bright	positive
squeals	negative
faithfully	positive
fumble	negative
messy	negative
aborted	negative
satisfying	positive
advantageous	positive
disrespect	negative
the	negative
dark	negative
hopelessness	negative
Edition,	positive
opportunistic	negative
equitable	positive
awed	positive
disastrous	negative
inadvisably	negative
salutary	positive
fast	positive
fond	positive
cataclysmic	negative
quarrel	negative
easy	positive
defy	negative
hedge	negative
this	positive
insinuating	negative
allegations	negative
difficult	negative
jaundiced	negative
unipolar	negative
rival	negative
honoring	positive
animosity	negative
mislead	negative
deceptive	negative
recalcitrant	negative
wealthy	positive
furiously	negative
dissembler	negative
effigy	negative
revolutionizes	positive
cliched	negative
gifted	positive
exhausts	negative
unbound	positive
prideful	negative
freakishly	negative
sensibly	positive
papers	positive
ominous	negative
unusable	negative
declines	negative
hustler	negative
breach	negative
handicapped	negative
sleek	positive
panicked	negative
fatalistically	negative
goofy	negative
sentence	positive
fierce	negative
exhorbitant	negative
nebulous	negative
lifesaver	positive
Comparing	positive
;	positive
boycott	negative
critics	negative
well-balanced	positive
confined	negative
chilly	negative
undefined	negative
miscalculation	negative
intolerance	negative
marvelousness	positive
manipulative	negative
discourteously	negative
bravado	negative
knowledgeable	positive
loud	negative
disruptive	negative
insidiously	negative
heartening	positive
elatedly	positive
heresy	negative
ripoff	negative
lethargic	negative
impolite	negative
admonition	negative
puzzling	negative
diatribes	negative
mordantly	negative
extortion	negative
stuck	negative
crumples	negative
mistake	negative
hostility	negative
louder	negative
pleasurably	positive
plea	negative
viciousness	negative
enjoy	positive
lethargy	negative
bombastic	negative
in	negative
perversity	negative
decay	negative
stately	positive
bulkiness	negative
glory	positive
disagreeable	negative
lacking	negative
dim	negative
inhibition	negative
eccentricity	negative
worried	negative
abuse	negative
flabbergast	negative
dextrous	positive
irresolvable	negative
respectfully	positive
skillfully	positive
obscure	negative
assail	negative
wrinkle	negative
mortifying	negative
unwise	negative
din	negative
wasted	negative
cherished	positive
repugn	negative
pleasure	positive
inefficacy	negative
cleverly	positive
non-confidence	negative
harmed	negative
bless	positive
resistance	negative
fallaciously	negative
excited	positive
polemize	negative
disgruntled	negative
pauper	negative
warmer	positive
protest	negative
They	negative
oversight	negative
loose	negative
can	negative
grumpy	negative
beckon	positive
nuisance	negative
shroud	negative
losses	negative
fervor	positive
impunity	negative
sleazy	negative
energetic	positive
upheaval	negative
morbidly	negative
blossom	positive
two	positive
gracefully	positive
adored	positive
smoldering	negative
brittle	negative
adaptive	positive
devastated	negative
backaches	negative
well	positive
archaic	negative
tolerable	positive
survivor	positive
offenses	negative
egregiously	negative
underestimate	negative
punch	negative
vice	negative
aggravate	negative
destructive	negative
dazzle	positive
pleas	negative
joy	positive
courteous	positive
bemused	negative
blissful	positive
irritable	negative
flattering	positive
glimmering	positive
petrify	negative
refine	positive
disdain	negative
slanders	negative
crumpled	negative
denunciate	negative
oppressiveness	negative
corrode	negative
fear	negative
orphan	negative
froze	negative
devil	negative
paranoid	negative
inflammation	negative
;	negative
jagged	negative
downloaded	negative
frustrate	negative
unlimited	positive
stampede	negative
grudgingly	negative
ruffian	negative
reliably	positive
prison	negative
rants	negative
contentment	positive
quibbles	negative
soundly	positive
bizarre	negative
crummy	negative
danger	negative
stupidly	negative
these	positive
apprehensively	negative
sprightly	positive
falsehood	negative
rejecting	negative
war-like	negative
clearly	positive
fraud	negative
entranced	positive
broke	negative
criticism	negative
loveless	negative
meticulously	positive
antagonism	negative
twists	negative
deform	negative
ruinous	negative
imperiously	negative
effusiveness	positive
ample	positive
disgustedly	negative
notoriously	negative
flatter	positive
slowed	negative
panick	negative
affluence	positive
drags	negative
unbelievable	negative
preferably	positive
inundated	negative
apathetic	negative
divinely	positive
entangle	negative
tingle	positive
afraid	negative
bruises	negative
liable	negative
monotony	negative
lover	positive
prestige	positive
enervate	negative
Chiba,	negative
famished	negative
decency	positive
(or	positive
prosecute	negative
self-satisfaction	positive
racists	negative
accuse	negative
foresight	positive
revert	negative
intrusion	negative
unwelcome	negative
bumping	negative
smoke	negative
useful	positive
inoperable	negative
harsh	negative
satisfactorily	positive
trustingly	positive
ovation	positive
immaculately	positive
gratify	positive
authoritative	positive
better-than-expected	positive
affliction	negative
desirable	positive
protective	positive
zealot	negative
dented	negative
maliciousness	negative
drunk	negative
egotistical	negative
overbalance	negative
injudicious	negative
anarchist	negative
tantalizing	positive
delaying	negative
qualm	negative
deceive	negative
incredulous	negative
askance	negative
complains	negative
first-class	positive
damn	negative
2004,	positive
Discovery	positive
godlike	positive
rip-off	negative
bickering	negative
Liu,	positive
reprimand	negative
can	positive
instable	negative
misspelled	positive
heathen	negative
awards	positive
mangle	negative
adulate	positive
dissident	negative
allergic	negative
uproarously	negative
back-wood	negative
hassles	negative
prudently	positive
geekier	positive
productively	positive
rot	negative
bruised	negative
enjoyable	positive
plot	negative
saintly	positive
outperforms	positive
marginal	negative
easygoing	positive
cheater	negative
cronyism	negative
resurgent	negative
immaterial	negative
tiresome	negative
insurmountably	negative
choleric	negative
all	negative
earnestly	positive
draconian	negative
grind	negative
improve	positive
contention	negative
deficient	negative
entrapment	negative
reforms	positive
rockstar	positive
scratched	negative
pinnacle	positive
eased	positive
ruthlessness	negative
banalize	negative
hostage	negative
bombardment	negative
misunderstanding	negative
killed	negative
imperil	negative
jeering	negative
contempt	negative
downfall	negative
aching	negative
despoiler	negative
erudite	positive
disadvantages	negative
lucid	positive
jeopardize	negative
halfheartedly	negative
rejected	negative
responsive	positive
inevitably	negative
flourishing	positive
testily	negative
pugnacity	negative
fucking	negative
falling	negative
dreary	negative
outcry	negative
extravagance	negative
objection	negative
carnage	negative
polished	positive
outrage	negative
dearth	negative
halfhearted	negative
sorrowful	negative
inconsequential	negative
admirable	positive
irony	negative
unsteady	negative
burn	negative
rut	negative
timely	positive
boastful	negative
repugnantly	negative
evasion	negative
unworthy	negative
imposing	negative
smile	positive
scarcity	negative
and	negative
damage	negative
brutalities	negative
laid-off	negative
dexterous	positive
horrifies	negative
windfall	positive
accuses	negative
seriousness	negative
smelly	negative
pain	negative
squeal	negative
touted	negative
deceivers	negative
outdo	positive
disrepute	negative
woebegone	negative
sully	negative
slaughter	negative
lambaste	negative
worse	negative
bogus	negative
flagrantly	negative
fails	negative
lanky	negative
choke	negative
feckless	negative
mischief	negative
indignant	negative
false	negative
passive	negative
understandable	positive
trickery	negative
suspicions	negative
uncouth	negative
angriness	negative
desirous	positive
irritation	negative
forlorn	negative
idolize	positive
favored	positive
obnoxious	negative
drab	negative
enemies	negative
unneeded	negative
brutalize	negative
unlikely	negative
kindliness	positive
disinclination	negative
helplessly	negative
invidious	negative
annoying	negative
distraughtness	negative
lengthy	negative
craftly	negative
and	negative
perplexity	negative
envious	positive
incognizant	negative
recomend	positive
unobserved	negative
rapport	positive
gratification	positive
criminal	negative
manipulate	negative
awkward	negative
obsessively	negative
despot	negative
one	negative
conflicting	negative
contamination	negative
impressiveness	positive
lagged	negative
strained	negative
confusion	negative
of	positive
geeky	positive
toxic	negative
fatefully	negative
matchless	positive
stylishly	positive
peacefully	positive
wreak	negative
Hu	positive
finely	positive
fortunately	positive
regression	negative
cracked	negative
World	negative
shady	negative
disturbed	negative
bleakly	negative
fresher	positive
suffice	positive
mocks	negative
infuriated	negative
avid	positive
homage	positive
misspelled	positive
mercilessly	negative
bewildering	negative
from	negative
hallowed	positive
adjustable	positive
be	positive
outsmart	positive
impinge	negative
onerously	negative
joyously	positive
hissing	negative
dungeon	negative
lesser-known	negative
will	negative
mishap	negative
laughably	negative
;	negative
loses	negative
cool	positive
scold	negative
officious	negative
repudiate	negative
omission	negative
weep	negative
plusses	positive
Bing	positive
fist	negative
devious	negative
shambles	negative
wrongful	negative
illumine	positive
blah	negative
stereotype	negative
restrict	negative
smuttier	negative
courage	positive
lacks	negative
crash	negative
mobster	negative
waste	negative
decent	positive
ultimatum	negative
mishandle	negative
disbelieve	negative
easiest	positive
blunt	negative
presumptuously	negative
starvation	negative
anti-american	negative
stiflingly	negative
clears	positive
Opinions	negative
toil	negative
phony	negative
astonishing	positive
pamper	positive
throttle	negative
hiss	negative
sever	negative
happily	positive
incorrigibly	negative
friggin	negative
upgradable	positive
unfinished	negative
affable	positive
emphatic	negative
boisterous	negative
disapointment	negative
incredibly	positive
impotent	negative
valuable	positive
raptureous	positive
derisive	negative
inordinately	negative
sensible	positive
miscreant	negative
worries	negative
stiff	negative
eagerly	positive
papers	negative
shameful	negative
recommended	positive
pretense	negative
superiority	positive
burdensomely	negative
remorse	negative
thumbs-up	positive
favorable	positive
reluctant	negative
brazenly	negative
succes	positive
second-tier	negative
straggler	negative
faultless	positive
shimmer	negative
bothered	negative
mislike	negative
fussy	negative
fatcat	negative
depress	negative
servitude	negative
unnerving	negative
excellence	positive
inelegance	negative
repetitive	negative
avalanche	negative
acrimoniously	negative
10-14,	positive
stupidity	negative
suspiciously	negative
provoke	negative
downside	negative
gloriously	positive
ruthlessly	negative
addict	negative
over-acted	negative
immoderately	negative
fastidious	negative
unfairly	negative
massacres	negative
titillate	positive
despondency	negative
sane	positive
thicker	negative
fib	negative
infection	negative
dominated	positive
squeak	negative
haze	negative
inconsistent	negative
shortsightedness	negative
disbelief	negative
paranoia	negative
exellent	positive
honorable	positive
addicts	negative
magnificently	positive
assuring	positive
colorful	positive
wholesome	positive
irrecoverablenesses	negative
vigilance	positive
bumpping	negative
admonishingly	negative
fancy	positive
disrespecting	negative
crafty	negative
openly	positive
brashly	negative
outrageous	negative
futile	negative
transgression	negative
gullible	negative
ungrateful	negative
annoy	negative
dastardly	negative
stumps	negative
melodramatic	negative
reluctantly	negative
botch	negative
emptiness	negative
imminently	negative
insatiable	negative
faithfulness	positive
impoverish	negative
successful	positive
hate	negative
peculiarly	negative
of	negative
muddle	negative
in	positive
turbulent	negative
inspiring	positive
sub-par	negative
(KDD-2004),	negative
gripe	negative
imprison	negative
wasteful	negative
lies	negative
cramping	negative
warped	negative
uplift	positive
unstable	negative
spoilages	negative
regrets	negative
scandel	negative
untimely	negative
unacceptable	negative
booming	positive
hegemony	negative
steadfast	positive
ruthless	negative
novelty	positive
retract	negative
dragoon	negative
comfortably	positive
conceded	negative
fabulously	positive
healthy	positive
set-up	negative
aggrivation	negative
avenge	negative
inimical	negative
See	positive
embroil	negative
ingeniously	positive
lousy	negative
prisoner	negative
dropouts	negative
one	positive
godsend	positive
interfere	negative
inviolable	positive
pest	negative
spook	negative
resent	negative
frightfully	negative
substantive	positive
rhetorical	negative
worryingly	negative
murder	negative
itch	negative
convoluted	negative
list	positive
inextricable	negative
subjugation	negative
accurate	positive
disgustful	negative
annoyed	negative
moronic	negative
ominously	negative
nervous	negative
derisiveness	negative
beguile	negative
squabble	negative
;	positive
crumble	negative
posturing	negative
awful	negative
despairingly	negative
god-send	positive
sinful	negative
This	negative
unravel	negative
corruptted	negative
playful	positive
insults	negative
dissapointed	negative
spurious	negative
oversimplified	negative
heavyhearted	negative
sumptuousness	positive
clarity	positive
exceeded	positive
concerned	negative
winning	positive
thrift	positive
brutally	negative
entrap	negative
slowww	negative
convience	positive
pessimistic	negative
annoys	negative
irretrievable	negative
cheapest	positive
outperformed	positive
mean	negative
unsuspecting	negative
illogic	negative
expansive	positive
bragger	negative
hardy	positive
protested	negative
;	positive
smouldering	negative
ruin	negative
calamitous	negative
needless	negative
splitting	negative
excellency	positive
accomplishments	positive
topple	negative
juddering	negative
agility	positive
irksomeness	negative
helpless	negative
prudence	positive
itchy	negative
bug	negative
shockingly	negative
swankiest	positive
hotcake	positive
crept	negative
sh*t	negative
International	positive
coarse	negative
ramshackle	negative
insidious	negative
struggle	negative
fallout	negative
greedy	negative
interferes	negative
inflexible	negative
despicable	negative
ambiguity	negative
arcane	negative
overwhelmingly	negative
neurotic	negative
filthy	negative
irregular	negative
acerbic	negative
graceless	negative
breakthrough	positive
quieter	positive
irk	negative
poetic	positive
savagery	negative
grimace	negative
painlessly	positive
lionhearted	positive
promise	positive
sue	negative
uninsured	negative
fictional	negative
a+	positive
resignation	negative
despised	negative
ironies	negative
fantastically	positive
slumpping	negative
indoctrination	negative
assult	negative
harms	negative
rumor	negative
disapprobation	negative
offensive	negative
diligent	positive
solace	positive
burden	negative
devastation	negative
impatience	negative
Washington,	positive
wrip	negative
noteworthy	positive
reliable	positive
crabby	negative
a	negative
spendy	negative
delayed	negative
desititute	negative
overacted	negative
infallibly	positive
scathing	negative
corrupt	negative
anti-	negative
plunderer	negative
crack	negative
warm	positive
vague	negative
upliftment	positive
barbarically	negative
hurts	negative
rascals	negative
cite	positive
smelled	negative
lack	negative
unparalleled	positive
commotion	negative
incapably	negative
outwit	positive
;	negative
entrust	positive
layoff-happy	negative
crowded	negative
hestitant	negative
incapable	negative
monster	negative
masterpieces	positive
blistering	negative
glib	negative
instigate	negative
difficulty	negative
isolation	negative
overzealous	negative
desolation	negative
demoralizing	negative
smitten	positive
toughness	negative
luxuriously	positive
hellion	negative
ethical	positive
languid	negative
fiendish	negative
inviolate	positive
decrepit	negative
fugitive	negative
wisely	positive
scams	negative
sufferers	negative
fat-cat	negative
vex	negative
soreness	negative
the	positive
stuttered	negative
overshadow	negative
time-honored	positive
eviscerate	negative
accommodative	positive
victorious	positive
superb	positive
strike	negative
leaky	negative
muscle-flexing	negative
snobish	negative
impedance	negative
dissention	negative
irragularity	negative
detests	negative
enmity	negative
tantrum	negative
hissed	negative
astonished	positive
hooligan	negative
despise	negative
virulently	negative
eyecatch	positive
refutes	negative
invaluablely	positive
vehemently	negative
Damerau),	negative
;	negative
divisively	negative
reassurance	positive
stridently	negative
annoyances	negative
cussed	negative
lame	negative
antithetical	negative
readable	positive
domineer	negative
undid	negative
expel	negative
magical	positive
obsessions	positive
stunned	positive
faulty	negative
incomparable	negative
annihilation	negative
gimmicking	negative
lucky	positive
jeers	negative
gratefully	positive
spontaneous	positive
steadiest	positive
qualms	negative
delirious	negative
tempt	positive
ineligible	negative
fairness	positive
fail	negative
whimper	negative
unrelenting	negative
uncomfortable	negative
tricked	negative
mind-blowing	positive
uncooperative	negative
displeasing	negative
hideousness	negative
flabbergasted	negative
defeats	positive
exasperated	negative
preoccupy	negative
heartfelt	positive
temerity	negative
threats	negative
feeblely	negative
worry	negative
integral	positive
disobey	negative
slick	positive
long-winded	negative
haughtily	negative
strong	positive
isolate	negative
;	positive
and	positive
tingled	negative
cringes	negative
disapprove	negative
flexible	positive
balk	negative
inequality	negative
complement	positive
refinement	positive
;	negative
floundering	negative
farfetched	negative
dissappointed	negative
tumble	negative
ecstasies	positive
unproved	negative
malevolently	negative
of	negative
loathing	negative
despotism	negative
congratulatory	positive
batty	negative
overstate	negative
impugn	negative
patient	positive
well-made	positive
err	negative
irresistible	positive
allegation	negative
sweeping	positive
sinking	negative
wise	positive
dreamland	positive
;	negative
believable	positive
goodly	positive
prettily	positive
first-rate	positive
;	positive
weird	negative
unimaginably	negative
oppressors	negative
disarm	negative
overtaxed	negative
embolden	positive
guiltless	positive
rash	negative
disservice	negative
scolded	negative
romantically	positive
ill-tempered	negative
bomb	negative
misread	negative
gripes	negative
cowardly	negative
use	positive
quarrellously	negative
glorious	positive
insouciance	negative
dissatisfying	negative
prosperity	positive
insinuate	negative
fidgety	negative
overbearing	negative
blindside	negative
disaffect	negative
rapturous	positive
livid	negative
leak	negative
egotism	negative
efficient	positive
amicable	positive
spookily	negative
amiss	negative
exalted	positive
Discovery	negative
speedily	positive
unreasonably	negative
demonized	negative
conspiracy	negative
tranquil	positive
exultant	positive
ingratitude	negative
temper	negative
POSITIVE	positive
kooky	negative
shrivel	negative
cons	negative
wobbled	negative
hiliarious	negative
grace	positive
worthiness	positive
forged	negative
ameliorate	positive
sincerity	positive
unhealthy	negative
fulminate	negative
counter-attacks	positive
freeze	negative
righten	positive
enchanting	positive
respectable	positive
rumours	negative
remission	positive
superstitious	negative
orderly	positive
misrepresentation	negative
expresses	negative
deception	negative
perfectly	positive
crueler	negative
repulsively	negative
amiability	positive
cataclysmically	negative
dissidents	negative
flexibility	positive
trusting	positive
inessential	negative
defiance	negative
suck	negative
effective	positive
crude	negative
jerky	negative
isolated	negative
creep	negative
disintegrates	negative
;	positive
gnawing	negative
bloated	negative
marvels	positive
extermination	negative
threaten	negative
mispronounced	negative
damaged	negative
gangster	negative
jerk	negative
breakdown	negative
tortures	negative
torturously	negative
nauseates	negative
handsomely	positive
swelled	negative
Aug	negative
capricious	negative
nightmarish	negative
streaky	negative
felicity	positive
startling	negative
fascinatingly	positive
kindness	positive
;	negative
simplify	positive
sucks	negative
decrepitude	negative
bore	negative
thumbs-down	negative
matte	negative
triumphal	positive
demonize	negative
willing	positive
indulge	negative
prominent	positive
spectacular	positive
rightfully	positive
pan	negative
desultory	negative
happier	positive
renounce	negative
sublime	positive
"Opinion	negative
browbeat	negative
horrifying	negative
thrive	positive
furious	negative
impudently	negative
;;;;;;;;;;;;;;;;;;;;;;;;;;;;;;;;;;;;;;;;;;;;;;;;;;;;;;;;;;;;;;;;;;;;;;;;;;;;;;	negative
fibber	negative
infested	negative
befoul	negative
uneasy	negative
useable	positive
titillatingly	positive
reward	positive
restriction	negative
gladly	positive
flicering	negative
vociferously	negative
International	negative
disgust	negative
grand	positive
expropriate	negative
;;;;;;;;;;;;;;;;;;;;;;;;;;;;;;;;;;;;;;;;;;;;;;;;;;;;;;;;;;;;;;;;;;;;;;;;;;;;	positive
accomplish	positive
sunken	negative
marvel	positive
vibrated	negative
empowerment	positive
contrived	negative
guarantee	positive
unfaithfully	negative
faltered	negative
hardliners	negative
discontinued	negative
criticizing	negative
rumple	negative
restructure	positive
menace	negative
victimize	negative
intimidate	negative
slanderous	negative
unrest	negative
Bing	negative
zealously	negative
wrinkled	negative
unrivaled	positive
attack	negative
accusing	negative
angrily	negative
depravedly	negative
rift	negative
pleasingly	positive
dangerousness	negative
unabashedly	positive
chaotic	negative
simplifying	positive
scandalously	negative
smoothest	positive
unrealistic	negative
scoldingly	negative
all-around	positive
revolutionize	positive
permissible	positive
junky	negative
advantage	positive
mournful	negative
wedge	negative
satisfy	positive
lament	negative
tangles	negative
indignation	negative
interruptions	negative
heretic	negative
unclear	negative
weak	negative
lethal	negative
conscons	negative
;	negative
slothful	negative
dripped	negative
savaged	negative
fallaciousness	negative
dizzingly	negative
abominably	negative
calumniously	negative
ACM	positive
forebodingly	negative
wonders	positive
They	negative
chaste	positive
gainful	positive
dishonorablely	negative
strain	negative
sickness	negative
problem-solver	positive
unfazed	positive
;	negative
deginified	positive
beseech	negative
shortchange	negative
"Mining	positive
exploitation	negative
enterprising	positive
recant	negative
static	negative
stumbles	negative
audibly	positive
crashed	negative
lie	negative
elite	positive
dependable	positive
gibe	negative
distort	negative
warning	negative
monstrosity	negative
F.	negative
acridly	negative
stringent	negative
demonic	negative
regretted	negative
detracting	negative
hail	positive
bearish	negative
warmly	positive
hell-bent	negative
tired	negative
Washington,	negative
illuminate	positive
prodigy	positive
Cheng.	positive
Web."	negative
sweetly	positive
beauteous	positive
displaced	negative
incorrect	negative
excitingly	positive
fancier	positive
fetid	negative
miraculously	positive
unacceptablely	negative
valor	positive
obtrusive	negative
straightforward	positive
upheld	positive
disaster	negative
brutal	negative
franticly	negative
lewdly	negative
petrified	negative
sob	negative
incoherent	negative
excellent	positive
savvy	positive
sketchy	negative
bid-rigging	negative
massacre	negative
cheapen	negative
vexation	negative
advantages	positive
ruts	negative
draconic	negative
crippling	negative
lurking	negative
sweetheart	positive
disaccord	negative
brainy	positive
correctly	positive
mockery	negative
Knowledge	negative
This	positive
luminous	positive
the	positive
gutsy	positive
audiciously	negative
please	positive
contradictory	negative
spite	negative
prickle	negative
improving	positive
outbreak	negative
recklessness	negative
crashes	negative
unreadable	negative
thank	positive
volatile	negative
dissuasive	negative
handy	positive
lugubrious	negative
aggrieve	negative
reprovingly	negative
revenge	negative
enthral	positive
passion	positive
symptom	negative
frolic	positive
discourage	negative
amputate	negative
delusional	negative
butcher	negative
guilt	negative
demise	negative
occluding	negative
endorse	positive
luck	positive
overture	positive
neurotically	negative
timidity	negative
fidelity	positive
Summarizing	positive
spoon-fed	negative
killing	negative
inadequate	negative
subjected	negative
scenic	positive
restructuring	positive
Observer:	negative
tremendously	positive
appreciative	positive
bonny	positive
fatuous	negative
deign	negative
relentlessness	negative
mistrust	negative
talented	positive
dignified	positive
horrifys	negative
Handbook	negative
autocratic	negative
sicken	negative
veritable	positive
incessantly	negative
enlighten	positive
the	positive
;	positive
destains	negative
heretical	negative
leaks	negative
politeness	positive
maniac	negative
accomodative	positive
harried	negative
washed-out	negative
uproot	negative
inferior	negative
sophisticated	positive
list.	negative
incongruously	negative
commiserate	negative
horrendous	negative
superstition	negative
media	negative
suffocate	negative
repugnance	negative
positives	positive
debaucher	negative
propitiously	positive
zapped	negative
inhumanity	negative
please	negative
purposeful	positive
importunate	negative
devilry	negative
denounce	negative
exquisitely	positive
autocrat	negative
poeticize	positive
humiliating	negative
gleefully	positive
inaudible	negative
better-known	positive
frenzy	negative
Opinions	positive
well-backlit	positive
anti-proliferation	negative
vibrating	negative
tidy	positive
scandalized	negative
contribution	positive
harass	negative
lags	negative
arduous	negative
unselfish	positive
favorited	positive
unsettling	negative
improves	positive
hegemonism	negative
dissatisfactory	negative
woo	positive
illusion	negative
rancor	negative
joke	negative
and	negative
modesty	positive
recommendations	positive
rich	positive
earnest	positive
"Sentiment	negative
well-managed	positive
overbearingly	negative
repulse	negative
fruitless	negative
wellbeing	positive
tortuous	negative
dirty	negative
misbehavior	negative
senselessly	negative
lagging	negative
picky	negative
accidental	negative
exalt	positive
tarnished	negative
fondly	positive
chintzy	negative
futility	negative
malign	negative
ideal	positive
senseless	negative
reprove	negative
Proceedings	negative
suffers	negative
bewilderment	negative
joker	negative
hazy	negative
premier	positive
boring	negative
rough	negative
fault	negative
unsupportive	negative
implication	negative
idiot	negative
posh	positive
mulish	negative
villify	negative
shortcoming	negative
implacable	negative
totalitarian	negative
foolhardy	negative
perverted	negative
confrontation	negative
awe	positive
expired	negative
congestion	negative
incitement	negative
frustrated	negative
lying	negative
abrupt	negative
gold	positive
hideous	negative
wasting	negative
unacceptably	negative
weaknesses	negative
uncollectible	negative
impiety	negative
insular	negative
rude	negative
geezer	negative
enjoying	positive
tentative	negative
workable	positive
calumny	negative
excruciatingly	negative
creeps	negative
anti-israeli	negative
surreal	positive
last-ditch	negative
prudent	positive
puzzlement	negative
attraction	positive
jobless	negative
woe	negative
obsessiveness	negative
unwatchable	negative
sued	negative
abundant	positive
insincerely	negative
disinterested	negative
throbs	negative
deny	negative
dissonant	negative
d*mn	negative
ecstatic	positive
inexpertly	negative
superbly	positive
immorally	negative
tense	negative
insightful	positive
improbably	negative
maddening	negative
naughty	negative
22-25,	negative
crap	negative
forswear	negative
selfinterested	negative
repel	negative
downsides	negative
anxieties	negative
insult	negative
harmonious	positive
bitingly	negative
puppets	negative
oppressively	negative
the	negative
pleasing	positive
smugly	negative
deft	positive
absence	negative
unabashed	positive
fair	positive
horde	negative
warp	negative
truant	negative
insensible	negative
trump	positive
blurred	negative
inane	negative
appearance	positive
disinterest	negative
entice	positive
monstrously	negative
liars	negative
discouraging	negative
stumble	negative
sorrow	negative
bullying	negative
May	positive
rabid	negative
insensitivity	negative
repulsed	negative
winnable	positive
courtly	positive
darkened	negative
positively	positive
capriciously	negative
shamefully	negative
obscured	negative
procrastinates	negative
suppression	negative
impulsively	negative
covetous	negative
brainwash	negative
cannibalize	negative
blameless	positive
insensitive	negative
unprofitable	negative
scorn	negative
disabled	negative
uncomplicated	positive
safely	positive
vomit	negative
over-valuation	negative
tantalizingly	positive
dishonesty	negative
frustrates	negative
anti-semites	negative
whips	negative
confrontational	negative
dissolution	negative
pale	negative
poor	negative
semi-retarded	negative
does	negative
unnaturally	negative
ebullient	positive
overwhelms	negative
disobedient	negative
redeem	positive
spew	negative
ineffective	negative
barbaric	negative
inaccuracies	negative
unsteadily	negative
smelt	negative
liability	negative
exploit	negative
barbarian	negative
negative	negative
buckle	negative
weed	negative
this	negative
scam	negative
instigator	negative
pestilent	negative
distains	negative
sermonize	negative
wild	negative
glistening	positive
chaff	negative
screwed	negative
pertinacity	negative
incompatability	negative
resourceful	positive
panicking	negative
displeased	negative
ulterior	negative
foolproof	positive
oddest	negative
conveniently	positive
USA,	negative
low-rated	negative
14th	positive
flout	negative
partiality	negative
compassion	positive
accessible	positive
abundance	positive
coherent	positive
slowwww	negative
gain	positive
problem	negative
Mining	negative
shamefulness	negative
boil	negative
intriguingly	positive
shirker	negative
offence	negative
boggle	negative
unwillingly	negative
overplay	negative
busybody	negative
smells	negative
cornerstone	positive
reverently	positive
dawdle	negative
puny	negative
malaise	negative
lower-priced	positive
sneaky	negative
uprising	negative
brutality	negative
troublesomely	negative
troubles	negative
indeterminable	negative
illusions	negative
nag	negative
slanderously	negative
ding	negative
undependable	negative
;	negative
sensations	positive
picturesque	positive
obscures	negative
liberty	positive
imminence	negative
noxious	negative
occlude	negative
litigious	negative
right	positive
drained	negative
unfriendly	negative
endorses	positive
formidable	positive
drippy	negative
tranquility	positive
sty	negative
cancer	negative
skeletons	negative
brute	negative
steadiness	positive
austere	negative
aches	negative
knife	negative
mesmerizes	positive
attractive	positive
disappointing	negative
unsecure	negative
radiance	positive
simplest	positive
breakthroughs	positive
payback	negative
perplexing	negative
erosion	negative
congenial	positive
Seattle,	positive
;	negative
infringe	negative
struggling	negative
overthrows	negative
astounding	positive
many	positive
conceited	negative
penalty	negative
indignity	negative
stun	negative
media	positive
diatribe	negative
wickedly	negative
bias	negative
large-capacity	positive
ecstasy	positive
scrambled	negative
gleeful	positive
awfulness	negative
annoyingly	negative
Proceedings	positive
tempest	negative
encourage	positive
untouched	negative
incivility	negative
sloooooooooooooow	negative
rascal	negative
tediously	negative
strongest	positive
nifty	positive
capably	positive
eloquent	positive
Mining	positive
spectacularly	positive
divisiveness	negative
insignificantly	negative
vindictive	negative
nave	negative
trophy	positive
regal	positive
insupportably	negative
soothe	positive
hero	positive
astray	negative
flatteringly	positive
heckles	negative
virtue	positive
(KDD-2004),	positive
grieve	negative
bashed	negative
peppy	positive
hampered	negative
;	negative
indulgent	positive
repugnant	negative
infidel	negative
prominence	positive
frenzied	negative
unuseably	negative
knave	negative
affectation	positive
creaking	negative
unexpected	negative
;	positive
charitable	positive
dilemma	negative
carefree	positive
flaking	negative
competitive	positive
hasseling	negative
revolutionized	positive
gall	negative
onslaught	negative
nitpicking	negative
impartially	positive
disturbance	negative
deadlock	negative
enthusiastically	positive
smokescreen	negative
wobble	negative
a	positive
defamations	negative
egomania	negative
errant	negative
enliven	positive
notice	negative
magnificent	positive
nemesis	negative
impose	negative
odd	negative
tenderness	negative
revoke	negative
alienated	negative
staunch	positive
chronic	negative
misses	negative
angelic	positive
betrays	negative
Comparing	negative
weary	negative
eruptions	negative
;	positive
boiling	negative
gentle	positive
unjustifiable	negative
tanks	negative
stutters	negative
delightfulness	positive
dehumanize	negative
well-known	positive
An	positive
anarchism	negative
Subjectivity."	positive
promising	positive
opinion	negative
disregardful	negative
unappealing	negative
Lexicon:	negative
donside	negative
deluded	negative
hobble	negative
forgetfulness	negative
saver	positive
repulsiveness	negative
atrocious	negative
unquestionable	positive
precariously	negative
sidetracked	negative
fast-paced	positive
peace	positive
excite	positive
discordance	negative
impartial	positive
sensationally	positive
noble	positive
brashness	negative
cunt	negative
longingly	negative
rejoice	positive
reasoned	positive
disconcerted	negative
debacle	negative
choppy	negative
harden	negative
unusual	negative
barbarously	negative
sticky	negative
overemphasize	negative
hardheaded	negative
error	negative
bad	negative
inefficient	negative
worrier	negative
denunciation	negative
tension	negative
2.	positive
feisty	positive
forgetfully	negative
undaunted	positive
be	negative
unemployed	negative
outmoded	negative
hardship	negative
luxuriant	positive
hale	positive
uproarous	negative
effusion	positive
pigs	negative
vouchsafe	positive
challenging	negative
dirt-cheap	positive
slur	negative
amaze	positive
whooa	positive
bedlamite	negative
overpayed	negative
bothering	negative
dupe	negative
villianous	negative
submissive	negative
badly	negative
bargain	positive
simplistic	negative
dust	negative
lighter	positive
nightmarishly	negative
shame	negative
flirty	negative
sad	negative
unfettered	positive
skimpy	negative
bountiful	positive
complaint	negative
treacherous	negative
kaput	negative
negate	negative
sharply	negative
degrade	negative
low-priced	positive
affinity	positive
conspicuous	negative
fatique	negative
bondage	negative
unquestionably	positive
enchantingly	positive
molestation	negative
unimaginable	negative
overstatements	negative
dissension	negative
unnervingly	negative
glower	negative
bestial	negative
seasoned	positive
abolish	negative
anarchistic	negative
scratch	negative
rusts	negative
knotted	negative
distinctive	positive
exemplary	positive
accomplishment	positive
troubled	negative
melodramatically	negative
inspiration	positive
secretive	negative
graceful	positive
sarcasm	negative
pitilessly	negative
improved	positive
risk-free	positive
time-consuming	negative
preferes	positive
belittling	negative
disgraceful	negative
overthrow	negative
smudge	negative
explosive	negative
dauntingly	negative
cajole	positive
fragmented	negative
unjustified	negative
audacious	negative
mispronounces	negative
symptoms	negative
ACM	negative
humble	positive
educated	positive
envious	negative
crazy	negative
astonish	positive
privileged	positive
beware	negative
fallacious	negative
squeaks	negative
tenderly	positive
intrude	negative
sour	negative
disprove	negative
misconceptions	negative
indeterminably	negative
like	positive
chapter	negative
ill-designed	negative
bastards	negative
smudging	negative
;	negative
glisten	positive
spirited	positive
prohibitive	negative
deploring	negative
liking	positive
poorly	negative
inconsiderately	negative
murky	negative
jubiliant	positive
fallacies	negative
bunk	negative
cruel	negative
tangled	negative
horrid	negative
corrupted	negative
aspirations	positive
helplessness	negative
improbable	negative
dissatisfy	negative
sluggish	negative
misconception	negative
peeve	negative
lukewarm	negative
astonishingly	positive
womanizing	negative
licentiously	negative
detesting	negative
cutthroat	negative
brutish	negative
offend	negative
solicitude	negative
tragic	negative
hang	negative
defeat	positive
maladjusted	negative
senile	negative
scared	negative
salacious	negative
harasses	negative
fav	positive
overheat	negative
list,	negative
stifle	negative
hostilities	negative
hindrance	negative
whoooa	positive
fudge	negative
clueless	negative
asperse	negative
entertains	positive
sap	negative
sag	negative
unwarranted	negative
hug	positive
horrendously	negative
below:	negative
sneer	negative
sexy	positive
gruff	negative
flicker	negative
chivalrous	positive
polluter	negative
creepy	negative
enhance	positive
relish	positive
struggled	negative
excel	positive
anarchy	negative
grin	positive
inescapable	negative
refusal	negative
unintelligile	negative
fuzzy	negative
ferocity	negative
intricate	positive
scandal	negative
outburst	negative
obstructs	negative
prestigious	positive
unconstitutional	negative
rattled	negative
hotcakes	positive
dreadful	negative
bereavement	negative
savage	negative
un-viewable	negative
iniquitous	negative
painful	negative
faith	positive
stealing	negative
sparkle	positive
selective	positive
misfit	negative
classy	positive
leakage	negative
brilliant	positive
extremist	negative
pales	negative
demonizing	negative
buoyant	positive
straining	negative
wripped	negative
unbearablely	negative
fatty	negative
necessarily	positive
rogue	negative
sturdy	positive
measly	negative
stimulate	positive
of	positive
backbiting	negative
outstanding	positive
bleeds	negative
frugal	positive
scorching	negative
pandering	negative
belligerent	negative
betrayal	negative
mistaken	negative
ambitiously	positive
reclaim	positive
zealous	negative
excelent	positive
priceless	positive
non-violence	positive
smoother	positive
fearfully	negative
laudably	positive
detracted	negative
exile	negative
upseting	negative
swank	positive
;	positive
guilty	negative
felicitous	positive
expire	negative
unavoidably	negative
dire	negative
kills	negative
drunkard	negative
refusing	negative
stagnation	negative
exuberantly	positive
energy-saving	positive
unsupported	negative
tardy	negative
dungeons	negative
stench	negative
costly	negative
roomier	positive
topnotch	positive
incorrectly	negative
devilment	negative
catchy	positive
drowning	negative
pervasive	negative
rejects	negative
impasse	negative
jeer	negative
delays	negative
deluge	negative
racist	negative
goad	negative
;	positive
overstates	negative
disappoints	negative
extravagantly	negative
oversimplification	negative
mispronounce	negative
unspeakable	negative
usable	positive
unsafe	negative
bothersome	negative
opinion	negative
careless	negative
exagerates	negative
condescendingly	negative
heartbreaker	negative
effortlessly	positive
misleadingly	negative
fiction	negative
stronger	positive
hotheaded	negative
idealize	positive
warlike	negative
immense	positive
fright	negative
overblown	negative
enviably	positive
perish	negative
raped	negative
confidence	positive
untenable	negative
daringly	positive
treasonous	negative
blotchy	negative
recklessly	negative
castrated	negative
coherence	positive
unscrupulous	negative
illiterate	negative
unsettlingly	negative
hazardous	negative
infernal	negative
bitch	negative
sanctimonious	negative
ached	negative
magnanimously	positive
draining	negative
zest	positive
recessionary	negative
irresponsibly	negative
Bing	positive
vileness	negative
runaway	negative
astounded	positive
blessing	positive
unfortunately	negative
checkered	negative
fervid	positive
and	negative
injustice	negative
affection	positive
wane	negative
revives	positive
celebratory	positive
quash	negative
darling	positive
cocky	negative
crowdedness	negative
nitpick	negative
mortify	negative
cozy	positive
devastates	negative
poise	positive
modern	positive
unconvincingly	negative
gawky	negative
headaches	negative
frail	negative
extravagant	negative
cheaply	negative
romantic	positive
ingenuous	positive
dripping	negative
astound	positive
that	positive
hostile	negative
heaven	positive
effortless	positive
revival	positive
vulgar	negative
weirdly	negative
gracious	positive
sorrowfully	negative
gladden	positive
derision	negative
complimentary	positive
Edition,	negative
iniquity	negative
distaste	negative
violent	negative
panders	negative
gloomy	negative
wonderously	positive
indebted	positive
disarray	negative
fabulous	positive
regretfully	negative
cringed	negative
fans	positive
throbbed	negative
scream	negative
comprehensive	positive
starkly	negative
beset	negative
hesitant	negative
dwindling	negative
mocking	negative
win	positive
collusion	negative
implode	negative
keenly	positive
naively	negative
feebleminded	negative
limits	negative
admirer	positive
debase	negative
mendacious	negative
lecher	negative
deformed	negative
desertion	negative
anti-occupation	negative
setback	negative
ashamed	negative
fun	positive
mangling	negative
unthinkable	negative
lecherous	negative
thoughtfully	positive
imperialist	negative
disrespectful	negative
paramount	positive
elate	positive
unnatural	negative
venerate	positive
retreat	negative
deviation	negative
advanced	positive
expulse	negative
babble	negative
wobbles	negative
blather	negative
patience	positive
disagreeing	negative
mightily	positive
banal	negative
Conference	positive
uncreative	negative
obsession	positive
miserly	negative
pugnaciously	negative
sloow	negative
sack	negative
bloody	negative
traumatized	negative
dizzy	negative
;	positive
tenuous	negative
infiltrator	negative
tantalize	positive
dazzling	positive
outstrip	positive
affordably	positive
thoughtfulness	positive
glitz	positive
selfishly	negative
jabber	negative
unskilled	negative
capability	positive
pollute	negative
asinine	negative
entertain	positive
craziness	negative
over-awe	negative
accolade	positive
inconsistencies	negative
unlawfully	negative
delude	negative
ferociously	negative
stupendous	positive
misunderstand	negative
confess	negative
excuse	negative
restless	negative
inhumane	negative
terrifically	positive
distortion	negative
snobbish	negative
upsettingly	negative
infiltrators	negative
inhibit	negative
mire	negative
villainously	negative
rectification	positive
tepid	negative
pompous	negative
surpass	positive
avarice	negative
punk	negative
screwed-up	negative
spookier	negative
roadblocks	negative
brat	negative
cashback	positive
illness	negative
tough	positive
die	negative
;	positive
trivially	positive
futuristic	positive
err-free	positive
subversion	negative
convienient	positive
;	negative
invincibility	positive
incoherently	negative
incongruous	negative
poison	negative
haywire	negative
concen	negative
fatalistic	negative
dispiriting	negative
diametrically	negative
tank	negative
defect	negative
unrestricted	positive
chastise	negative
hating	negative
;	positive
dull	negative
of	negative
admiring	positive
dissuade	negative
grouch	negative
fumes	negative
impending	negative
faint	negative
on	negative
rightful	positive
affirm	positive
unmatched	positive
inactive	negative
misuse	negative
stupendously	positive
bruise	negative
fears	negative
tempting	positive
honesty	positive
shemale	negative
bloodshed	negative
misaligns	negative
awarded	positive
humour	positive
innovation	positive
enchant	positive
niggles	negative
;	positive
violently	negative
plasticky	negative
upgraded	positive
(or	negative
blurry	negative
sags	negative
incompliant	negative
polution	negative
prejudicial	negative
dissatisfied	negative
denigrate	negative
fervent	positive
oasis	positive
perfidity	negative
negatives	negative
best-selling	positive
muddy	negative
extraordinarily	positive
reasonably	positive
irks	negative
unethical	negative
shark	negative
;	negative
and	positive
bumped	negative
inflammatory	negative
adversary	negative
abused	negative
wreck	negative
bliss	positive
drastic	negative
unfortunate	negative
frown	negative
deserving	positive
bulky	negative
enraged	negative
mockingly	negative
wows	positive
bravery	positive
comforting	positive
illegal	negative
undecided	negative
suavely	positive
marginally	negative
ludicrously	negative
The	positive
wanton	negative
indigent	negative
rampage	negative
splendid	positive
Bing	positive
insufficient	negative
covenant	positive
genuine	positive
barbarous	negative
undesirable	negative
dotingly	positive
disgracefully	negative
;	negative
Damerau),	positive
less-developed	negative
disputable	negative
evaluative	positive
deceitfulness	negative
a	positive
restlessness	negative
smut	negative
obstructed	negative
cataclysmal	negative
figurehead	negative
bleak	negative
hatefully	negative
wily	negative
vanity	negative
clique	negative
prohibitively	negative
aground	negative
impenitent	negative
applaud	positive
dirtbag	negative
unforgettable	positive
confusing	negative
fury	negative
precious	positive
hypocritically	negative
felonious	negative
deficiency	negative
horrific	negative
pardon	positive
womanizer	negative
amply	positive
;	negative
uproariously	negative
wretchedness	negative
midget	negative
second-class	negative
blasted	negative
sly	negative
gainsayer	negative
trust	positive
horrified	negative
famously	positive
humourous	positive
gaudy	negative
mudslinging	negative
remorselessly	negative
strut	negative
sunk	negative
qualify	positive
disappoint	negative
rebuke	negative
;	positive
stunning	positive
May	negative
languorously	negative
genius	positive
hypocrisy	negative
whoa	positive
desecrate	negative
vexing	negative
rape	negative
eagerness	positive
comfortable	positive
degrading	negative
disintegrate	negative
rightly	positive
joyfully	positive
